Index of “Urantia Association of Spain” articles	Index des articles de l'Association Urantia d'Espagne
First part	Première partie
Mr. Hubble and the Urantia Papers	M. Hubble et les Cahiers d'Urantia
A Letter to Astronomers and Astrophysicists	Lettre aux astronomes et aux astrophysiciens – 2016
Matter and Energy: Physics and The Urantia Book	Matière et énergie : la physique et le Livre d'Urantia
Appearance on the cosmic stage of matter and energy	Apparition sur la scène cosmique de la matière et de l'énergie
Summary on the Conjoint Actor	Résumé de l'Ensemble Actor
Is the superuniverse of Orvonton the Milky Way?	Le superunivers d'Orvonton : est-ce la Voie lactée ?
A Simplification of the Foreword to The Urantia Book	Une simplification de l'avant-propos du Livre d'Urantia
Architects of Master Universe	Les architectes du Maître Univers
History of Creation	Histoire de la création
Breve historia de la Creación	Une brève histoire de la création
A Look at the General Organization of the Master Universe	Coup d'œil sur l'organisation générale du Maître Univers
Is Orvonton The Milky Way?	Orvonton est-elle la Voie lactée ?
Cosmology of the universe of universes	Cosmologie de l'univers des univers
Transformative Techniques	Techniques de transformation
Superuniverse of Orvonton, Milky Way?	Le superunivers d'Orvonton : la Voie lactée ?
Astronomía urantiana, una visión personal	L'astronomie urantienne, une vision personnelle
Newton and his concept of space	Newton et sa conception de l'espace
The contraction of Space Time	La contraction de l'Espace Temps
Second part	Deuxième partie
History of Nebadon	Histoire de Nébadon
Neutrinos, Neutrons, and Neutron Stars	Neutrinos, neutrons et étoiles à neutrons
The Sun and its destiny	Le Soleil et son destin
The ascending career	La course vers le sommet
An approximation to the local universe of Nebadon	Une approche de l'univers local de Nébadon
A Day in the Life of a Mansion Worlds Student	Une journée dans la vie d'un étudiant du monde des manoirs
Chronology of the local universes	Une Étude du Maître Univers — Appendice IX. La chronologie des univers locaux
Our Creative Deities - A Supreme Relationship	Nos divinités créatrices – Une relation suprême
Gravity, Newton, Einstein and The Urantia Book	La gravité, Newton, Einstein et le Livre d'Urantia
Surfing The Sunbeams-Calcium, TheWanderer of Space	Surfer sur les rayons du soleil : Calcium, le vagabond de l'espace
Introduction to the second part	Introduction à la deuxième partie
Outline of the Seraphic Organization	Aperçu de l'organisation séraphique
Evolution on a normal planet	L'évolution sur une planète normale
Freedom	Liberté
The Strong Force in the Atomic Nucleus Prophesied in 1934	La force de gravité dans le noyau atomique prophétisée en 1934
From matter to Spirit via the mind	De la matière à l'Esprit en passant par le mental
Unprovability of the existence of God	L'impossibilité de prouver l'existence de Dieu
Material Time — Morontia Time — Spiritual Time	Le temps matériel — le temps morontiel — le temps spirituel
Third part	Troisième partie
Family life on the neighboring planet	La vie de famille sur la planète voisine
Urartu the lost kingdom of Van	Urartu, le royaume perdu de Van
The new religion	La nouvelle religion
History of Urantia	Histoire d'Urantia
Horsing Around	Domestication du cheval
Gobekli Tepe	Göbekli Tepe
Early migration to Britain	Les premières migrations vers la Grande-Bretagne
Pangaea to Plate Tectonics	De la Pangée à la tectonique des plaques
Adam and Eve	Rapport sur Adam et Eve
Garden of Eden	Rapport sur le jardin d'Eden
Creating fire	Créer un feu
The Jupiter problem	Le problème de Jupiter
Worlds of Monmatia	Les corps spatiaux de Monmatia
Urantian Reflections on Human Institutions	Réflexions urantiennes sur les institutions humaines
What to do with human evolution?	Que faire de l’évolution humaine ?
Charla sobre adoración y meditación	Conférence sur le culte et la méditation
The government of a neighboring planet: the possible utopia	Le gouvernement d'une planète voisine : l'utopie possible
The Supreme Being and previous concepts	L'Être suprême et les concepts antérieurs
One man's journey through evolutionary adventure	Le voyage d'un homme à travers l'aventure évolutive
Comments on the paper “One man's journey through evolutionary adventure”	Commentaires sur l'ouvrage « One Man's Walk Through the Evolutionary Debate »
Urantian Migrations	Migrations urantiennes
Where are the Daughters of God?	Où sont les Filles de Dieu ?
The Thought Adjuster and the experience	L'Ajusteur et l'expérience
Ethical Eugenics	Eugénisme éthique : une modeste proposition pour le 21e siècle
The Supreme Being	L'Être suprême
About paper 105	À propos du fascicule 105
Marriage and family life	Mariage et vie de famille
Introduction to the third part	Introduction à la troisième partie du Livre d'Urantia
In communication with our Thought Adjuster	En communication avec notre Ajusteur de Pensée
Meditate, pray and worship	Méditez, priez et adorez
The Dual Nature of Supremacy	La double nature de la suprématie
The origin of writing	L'origine de l'écriture
The “isms” and The Urantia Book	Les « ismes » et le Livre d'Urantia
Evolution or creation?	Évolution ou création ?
What Really Survives?	Qu'est-ce qui survit vraiment ?
Fourth part	Quart partie
Raising children in the family: the example of Jesus	L'éducation des enfants dans la famille : l'exemple de Jésus
Invitation to read at Christmas	Invitation à lire en Noël
After the Last Supper: The Farewell Discourse	Après la Cène : le discours d'adieu
The world of the cross	Le monde de la croix
The figure of Jesus of Nazareth	La figure de Jésus de Nazareth
To the educators and believers of the fifth revelation	Aux éducateurs et aux croyants de la cinquième révélation
Los otorgamientos de Cristo Miguel	Les dons du Christ Michel
Los doce apóstoles	Les douze apôtres
Reflections on the parable of the mustard seed	Réflexions sur la parabole du grain de moutarde
Jesus and the women	Jésus et les femmes
The scribe of Damascus	L'écrit de Damasco
The Kingdom of Heaven in the 21st Century	Le Royaume des Cieux au XXIe siècle
Chronology of Jesus' life according to The Urantia Book	Chronologie de la vie de Jésus selon Le Livre d'Urantia
The life and teachings of Jesus	La vie et les enseignements de Jésus
Images about Jesus	Images et peintures de Jésus
There was only one winner	Il n'y avait qu'un seul gagnant
Easter week	La Semaine Sainte ??? – et d’autres comme elle
Believe	Croire
We have come across the Church	Nous nous sommes heurtés à l’Église
Reflections on the first papers of Part Four	Réflexions sur les premiers documents de la quatrième partie
The Art of Living	L'art de vivre — selon Jésus et le livre d'Urantia
Chronology of Jesus' life on Urantia	Chronologie de la vie de Jésus sur Urantia
Comments on paper 179: The Last Supper	La Cène
Who was Jesus?	Qui etait Jesus ?
Jesus—Inspiration and Friend	Jésus – Inspiration et ami
Was the Crucifixion Really Necessary?	La crucifixion était-elle vraiment nécessaire ?
Jesus, Man, and Myth	Jésus, l'homme et le mythe
Paul and Abner	Paul et Abner
Miscellany	Recueil
Utopia as certainty	L'utopie comme certitude
The Urantia Book and the collapse of capitalist era	Le Livre d'Urantia et l'effondrement de l'ère capitaliste
Health, illness and death	Santé, maladie et mort
Technology and Science in Light of The Urantia Book	Technologie et science à la lumière du Livre d'Urantia
Work, business and money	Travail, affaires et argent
Meditation in the Urantian Movement	Méditation dans le mouvement urantien
A cry for hope	Un cri d'espoir
The Urantia movement in Spain	Le mouvement Urantia en Espagne
A History of the Urantia Movement	L'Histoire du Mouvement Urantia
The challenges of the leaders of the fifth revelation	Les défis des dirigeants de la cinquième révélation
The Quran under the spiritual lights of The Urantia Book	Le Coran sous les lumières spirituelles du Livre d'Urantia
From tribe to cosmic citizenship	De la tribu à la citoyenneté cosmique
Answers for those who do not believe	Réponses pour ceux qui ne croient pas
Astronomy and superuniverses	Astronomie et superunivers
The pursuit of happiness in light of the teachings of The Urantia Book	La poursuite du bonheur à la lumière des enseignements du Livre d'Urantia
The Inner Life: Upward	La vie intérieure : vers le haut
The Inner Life: Towards God	La vie intérieure : vers Dieu
The inner life: outward	La vie intérieure : vers l'extérieur
Testimonials from readers of The Urantia Book	Témoignages de lecteurs du Livre d'Urantia
The hand that rocks the cradle	La main qui berce le berceau
Signs	Indices
Friends and residents of Urantia	Amis et résidents sur Urantia
The Urantia Book in Study Groups	Le Livre d'Urantia dans les Groupes d'Étude
The Urantia Book: Why, How, What	Le Livre d'Urantia : Pourquoi, Comment, Quoi
Presentation of The Urantia Book in «La Caja de Pandora»	Présentation du Livre d'Urantia à la « boîte de Pandore »
Key dates in the history of The Urantia Book	Dates clés de l'histoire du Livre d'Urantia
Being free	L'Être libre
Science, Philosophy, Religion and Revelation	Science, philosophie, religion et révélation
Advertising and The Urantia Book	La publicité et le Livre d'Urantia
Opinions and comments	Avis et commentaires
Religious peace	La paix religieuse
Science cannot replace religion	La science ne peut pas remplacer la religion
Life, death and eternity	La vie, la mort et l'éternité
You Be The Book	Tu es le livre
Description of The Urantia Book	Description du Livre d'Urantia
The Urantia Book in the books of J.J. Benítez	Le Livre d'Urantia dans les livres de J.J. Benítez
A Jewish Girl Finds Jesus	Une jeune fille juive trouve Jésus
The Personality	La Personnalité
Anova	Anova (première partie)
Evolution and progress	Évolution et progrès
Why have faith?	Pourquoi avoir la foi ?
The true religion	La vraie religion
Factor 100	Le Facteur 100 ou les 757 575 ans qui nous séparent (peut être) du Paradis
About personality	À propos de la personnalité
How to Get the Urantia Book Out	Comment faire connaître le Livre d'Urantia
Approach to some scientific aspects of The Urantia Book	Approche de quelques aspects scientifiques du Livre d'Urantia
The Cultural Impact of The Urantia Book in the Next Fifty Years	L'impact culturel du Livre d'Urantia dans les cinquante prochaines années
The role of emotions in the spiritual quest	Le róle des émotions dans la recherche spirituelle
How Big is Orvonton, really?	Quelle est vraiment la taille d'Orvonton ?
Moussa N'Diaye's first seminar	Le premier séminaire de Moussa N'Diaye
The slaveries of man	Les esclavages de l'homme
What Does The Urantia Book Instruct Concerning the Dissemination of Its Teachings?	Que nous dit de faire Le Liure d'Urantia à propos de la dissémination de ses enseignements?
The evolution of reincarnation and karma	L'évolution de la réincarnation et du karma
A description of reality	Une description de la réalité
A new thought	Une nouvelle pensée
Synthesis of reality	Synthèse de la réalité
Teamwork	Le travail d' équipe
Creation According to The Urantia Book	La Création selon le Livre d'Urantia
Consciousness, determinism and materialism	Conscience
The Urantia Book and its dissemination	Le Livre d'Urantia et sa diffusion
Technological Future	Avenir technologique
Ethics and Morals	Éthique et morale
New interpersonal relationships	Nouvelles relations interpersonnelles
Orientation and knowledge	Orientation et connaissances
Consideration of Some Criticisms of The Urantia Book	Considération de quelques critiques du Livre d'Urantia
Bill Sadler Talks	Bill Sadler parle
The Human Mind According to Bill Sadler	L'esprit humain selon Bill Sadler