Index of “Le Lien”, French Urantia Association Journal	Index de « Le Lien », Journal de l'Association Francophone de Lecteurs du Livre d'Urantia
1996	1996
Le Lien Urantien — Issue 1 — Summer 1996	Le Lien Urantien — Numéro 1 — Été 1996
Le Lien Urantien — Issue 1 — Summer 1996 — Contents	Le Lien Urantien — Numéro 1 — Été 1996 — Contenu
A short story about personality	Petite histoire à propos de la personnalité
Infallible cosmic compass	Infaillible compas cosmique
Reflection: They tell us...	Reflexion : Ils nous disent...
The Adjuster according to C.G. Jung	L'Ajusteur selon C.G. Jung
When a little peace descends upon us	Quand un peu de paix descend sur nous
Urantia on the Internet	Urantia sur Internet
Le Lien Urantien — Issue 2 — Autumn 1996	Le Lien Urantien — Numéro 2 — Automne 1996
Le Lien Urantien — Issue 2 — Autumn 1996 — Contents	Le Lien Urantien — Numéro 2 — Automne 1996 — Contenu
Artistic conception of the Master Universe	Conception artistique du Maitre Univers
Report of the 3rd International Conference of Associations Affiliated to the I.U.A.	Compte rendu de la 3ème Conférence Internationale des Associations Affiliées à l’I.U.A.
Meeting of the translators of the URANTIA Book organized by the URANTIA Foundation in PARIS in April 1996	Réunion des traducteurs du Livre d’URANTIA organisée par la Fondation URANTIA à PARIS en Avril 1996
The Consecration	La Consécration
Le Lien Urantien — Issue 3 — Winter 1996	Le Lien Urantien — Numéro 3 — Hiver 1996
Le Lien Urantien — Issue 3 — Winter 1996 — Contents	Le Lien Urantien — Numéro 3 — Hiver 1996 — Contenu
Artistic conception of the Master Universe (2)	Conception artistique du Maitre Univers (2)
The Personality	La Personnalité
Bruno Bettelheim and our anguished era	Bruno Bettelheim et notre époque angoissée
1997	1997
Le Lien Urantien — Issue 4 — Summer 1997	Le Lien Urantien — Numéro 4 — Été 1997
Le Lien Urantien — Issue 4 — Summer 1997 — Contents	Le Lien Urantien — Numéro 4 — Été 1997 — Contenu
The American justice system rules in favor of copyright on appeal	La justice americaine se prononce en appel en faveur du copyright
After death	Après la mort
Deity and divinity	Déité et divinité
The Personality (2)	La Personnalité (2)
Supremacy	Suprématie
Le Lien Urantien — Issue 5 — Autumn 1997	Le Lien Urantien — Numéro 5 — Automne 1997
Le Lien Urantien — Issue 5 — Autumn 1997 — Contents	Le Lien Urantien — Numéro 5 — Automne 1997 — Contenu
International Conference of the I.U.A. in Helsinki from August 7 to 10, 1998	Conférence Internationale de l’I.U.A. à Helsinki du 7 au 10 août 1998
Meeting of September 21, 1997 in Villebon-Sur-Yvette	Rencontre du 21 Septembre 1997 a Villebon-Sur-Yvette
Metaphysical Thoughts of an Agnostic	Pensees metaphysiques d’un agnostique
Coherence, or Principle of Evanescence?	Coherence, ou principe d’evanescence ?
The Spirit of Truth: Unifying Pole of Religions?	L’Esprit de Verite : pole unificateur des religions ?
Personality, Identity, Divinity	Personnalite, Identite, Divinite
1998	1998
Le Lien Urantien — Issue 6 — Summer 1998	Le Lien Urantien — Numéro 6 — Été 1998
Le Lien Urantien — Issue 6 — Summer 1998 — Contents	Le Lien Urantien — Numéro 6 — Été 1998 — Contenu
Awaiting the Resurrection	En attendant la résurrection
Contribution to Jean Royer's article “Coherence, or principle of evanescence?” from Lien n5	Contribution à l'article de Jean Royer « Cohérence, ou principe d'évanescence ? » du Lien n5
Le Lien Urantien — Issue 7 — Autumn 1998	Le Lien Urantien — Numéro 7 — Automne 1998
Le Lien Urantien — Issue 7 — Autumn 1998 — Contents	Le Lien Urantien — Numéro 7 — Automne 1998 — Contenu
The Urantia Book and Children	Le Livre d’Urantia et les enfants
Emergence and Finality of Worship	Emergence et finalite de l’adoration
IUA Conference Reports	Compte rendu des conférences IUA
Le Lien Urantien — Issue 8 — Winter 1998	Le Lien Urantien — Numéro 8 — Hiver 1998
Le Lien Urantien — Issue 8 — Winter 1998 — Contents	Le Lien Urantien — Numéro 8 — Hiver 1998 — Contenu
The Intelligence of the Heart	L'intelligence du cœur
What is What Happens After Death?	Que se passe-t-il apres la mort ?
Absolutes and Reality	Absolus et realite
1999	1999
Le Lien Urantien — Issue 9 — Spring 1999	Le Lien Urantien — Numéro 9 — Printemps 1999
Le Lien Urantien — Issue 9 — Spring 1999 — Contents	Le Lien Urantien — Numéro 9 — Printemps 1999 — Contenu
Cooperation with the Adjuster	Cooperation avec l’Ajusteur
Who Was Jesus?	Qui etait Jesus ?
The Three Great Human Experiences	Les trois grandes experiences de l’etre humain
Trinitization	La trinitisation
The Seven Circuits of Havona	Les sept circuits de Havona
Le Lien Urantien — Issue 10 — Summer 1999	Le Lien Urantien — Numéro 1 — Été 1999
Le Lien Urantien — Issue 10 — Summer 1999 — Contents	Le Lien Urantien — Numéro 10 — Été 1999 — Contenu
The Identification Process	Le processus d'identification
The Evolution of Fetishism and Idols “Sacred Books”	L’evolution du fetichisme et idoles « livres sacres »
Who Was Jesus? (Part 2)	Qui etait Jesus ? (2ème partie)
Reflections on the Jesus Prayer	Reflexions à propos de la prière de Jésus
Joseph’s Death and Destiny	La mort de Joseph et le destin
Le Lien Urantien — Issue 11 — Autumn 1999	Le Lien Urantien — Numéro 1 — Automne 1999
Le Lien Urantien — Issue 11 — Autumn 1999 — Contents	Le Lien Urantien — Numéro 10 — Automne 1999 — Contenu
The Urantia Book in Africa	Le livre d’Urantia en Afrique
Who Was Jesus? (end)	Qui était Jésus ? (fin)
Facts, Meanings, and Values	Faits, significations et valeurs
Poem…	Poème…
Le Lien Urantien — Issue 12 — Winter 1999	Le Lien Urantien — Numéro 1 — Hiver 1999
Le Lien Urantien — Issue 12 — Winter 1999 — Contents	Le Lien Urantien — Numéro 10 — Hiver 1999 — Contenu
“About” the Apostle Paul	« A propos » de l’apôtre Paul
The Decision Center	Le centre de decision
My Adjuster and I	Mon Ajusteur et moi
2000	2000
Le Lien Urantien — Issue 13 — Spring 2000	Le Lien Urantien — Numéro 13 — Printemps 2000
Le Lien Urantien — Issue 13 — Spring 2000 — Contents	Le Lien Urantien — Numéro 13 — Printemps 2000 — Contenu
A fire	Un feu
Melchizedek or the 2nd Revelation	Melchizédek ou la 2ème Révélation
Does God exist?	Dieu existe-t-il ?
What Would Jesus do ?	«What Would Jesus do ?»
Le Lien Urantien — Issue 14 — Summer 2000	Le Lien Urantien — Numéro 14 — Été 2000
Le Lien Urantien — Issue 14 — Summer 2000 — Contents	Le Lien Urantien — Numéro 14 — Été 2000 — Contenu
Variations around a Center of Gravity	Variations autour d'un Centre de Gravité
The Dual Nature of Supremacy	La nature duelle de la Sûprematie
Reflections on the Jesus Prayer (2)	Réflexions à propos de la prière de Jésus (2)
The Mystery of the Maries	Le mystère des Maries
Le Lien Urantien — Issue 15 — Autumn 2000	Le Lien Urantien — Numéro 15 — Automne 2000
Le Lien Urantien — Issue 15 — Autumn 2000 — Contents	Le Lien Urantien — Numéro 15 — Automne 2000 — Contenu
The Animal Mind	Le mental animal
A Small, Well-Filled Bottle	Petite bouteille bien pleine
Supreme Rant-ings	Suprêmes élucubrations
International Meeting of 2002 Progress Report No. 3	Rencontre internationale de 2002 État d'avancement nº 3
Report of the CNP Meeting in New York on August 2, 2000	Compte-rendu de la réunion du CNP à New-York le 2 août 2000
Le Lien Urantien — Issue 16 — Winter 2000	Le Lien Urantien — Numéro 16 — Hiver 2000
Le Lien Urantien — Issue 16 — Winter 2000 — Contents	Le Lien Urantien — Numéro 16 — Hiver 2000 — Contenu
The Facets of Truth	Les facettes de la Vérité
UB Readers' Meeting	Réunion de lecteurs du LU
The Contraction of Space-Time	La contraction de l'Espace Temps
Proposals and Reflections on the 2002 Meeting	Propositions et réflexions sur la réunion de 2002
2001	2001
Le Lien Urantien — Issue 17 — Spring 2001	Le Lien Urantien — Numéro 17 — Printemps 2001
Le Lien Urantien — Issue 17 — Spring 2001 — Contents	Le Lien Urantien — Numéro 17 — Printemps 2001 — Contenu
Democracy	La démocratie
Living Our Father's Will: A Daily Experience	Vivre la volonté de notre Père : une expérience au quotidien
Good Behavior	Le bon comportement
Relaxation Corner: The Mason and the Great Architect	Coin détente : Le maçon et le grand architecte
Regain	Regain
The Text of “Treasure” Explained	Le texte du « Trésor » expliqué
To My Immortal Soul	A mon âme immortelle
Gazette Section: At the Mother House	Rubrique de la Gazette: A la maison-mère
The Little Bottle Is Still Filling Up	La petite bouteille se remplit encore
Le Lien Urantien — Issue 18 — Summer 2001	Le Lien Urantien — Numéro 18 — Été 2001
Le Lien Urantien — Issue 18 — Summer 2001 — Contents	Le Lien Urantien — Numéro 18 — Été 2001 — Contenu
Brief reflection on the mind	Brève réflexion sur le mental
The role of emotions in spiritual research	Le róle des émotions dans la recherche spirituelle
Truth and lies or Facts and falsehood	Vérité et mensonge ou Des faits et de la fausseté
Relaxation corner: Impressions of the future	Coin détente : Impressions d'avenir
The angel	L'ange
After the meeting of May 2001 at N. D. des Lumiêres	Aprés la rencontre de mai 2001 à N. D. des Lumiêres
Le Lien Urantien — Issue 19 — Autumn 2001	Le Lien Urantien — Numéro 19 — Automne 2001
Le Lien Urantien — Issue 19 — Autumn 2001 — Contents	Le Lien Urantien — Numéro 19 — Automne 2001 — Contenu
Anova (Part One)	Anova (première partie)
The Power to Choose	Le pouvoir de choisir
The Supreme, God the Sevenfold, Forces, Energies and Universal Control of Power: 100 Questions and Answers (1)	Le Suprême, Dieu le Septuple, Forces, Énergies et Contrôle Universel de Pouvoir: 100 Questions et Réponses (1)
Art and Testimonies	Art et témoignages
Relaxation Corner Poem	Coin détente Poème
Le Lien Urantien — Issue 20 — Winter 2001	Le Lien Urantien — Numéro 20 — Hiver 2001
Le Lien Urantien — Issue 20 — Winter 2001 — Contents	Le Lien Urantien — Numéro 20 — Hiver 2001 — Contenu
Life	La Vie
Anova (Part Two)	Anova (deuxième partie)
There are the Urantian Years and...	Il y a les années urantiennes et...
The Supreme, God the Sevenfold, Forces, Energies and Universal Power Control: 100 Questions and Answers (2)	Le Suprême, Dieu le Septuple, Forces, Énergies et Contrôle Universel de Pouvoir : 100 Questions et Réponses (2)
Art and Testimonies	Art et témoignages
2002	2002
Le Lien Urantien — Issue 21 — Spring 2002	Le Lien Urantien — Numéro 21 — Printemps 2002
Le Lien Urantien — Issue 21 — Spring 2002 — Contents	Le Lien Urantien — Numéro 21 — Printemps 2002 — Contenu
The Fourth Age	Le Quatrième age
Joy	La Joie
Freedom	Liberté
A Glimpse of the General Organization of the Master Universe and Theory of Totality by the Researchers of Uversa	Coup d'œil sur l'organisation générale du Maître Univers et théorie de la totalité par les chercheurs d'Uversa
Should a New Church Be Founded?	Doit-on fonder une nouvelle église ?
Rotation	Rotation
Full Line from the Most High	Trait plein du très haut
Le Lien Urantien — Issue 22 — Summer 2002	Le Lien Urantien — Numéro 22 — Été 2002
Le Lien Urantien — Issue 22 — Summer 2002 — Contents	Le Lien Urantien — Numéro 22 — Été 2002 — Contenu
Reality Synthesis	Synthèse de la réalité
Life Carriers	Porteurs de vie
Teamwork	Le travail d' équipe
Seasons	Saisons
Le Lien Urantien — Issue 23 — Autumn 2002	Le Lien Urantien — Numéro 23 — Automne 2002
Le Lien Urantien — Issue 23 — Autumn 2002 — Contents	Le Lien Urantien — Numéro 23 — Automne 2002 — Contenu
Missions	Missions
Does Man Need God to Live? Is It Weakness to Believe in God?	L'homme a-t-il besoin de Dieu pour Vivre ? Est-ce faiblesse de croire en Dieu?
The Directors of the Census	Les Directeurs du Recensement
Dalamatia, the City of the Hundreds of Caligastia, Dilmun, the City of the Nodites	Dalamatia, la cité des cents de Caligastia, Dilmun, la cité des nodites
Retreats	Retraites
Poem for Jesus	Poème pour Jésus
Clarity	Clarté
August in Dourdan	Août à Dourdan
Le Lien Urantien — Issue 24 — Winter 2002	Le Lien Urantien — Numéro 24 — Hiver 2002
Le Lien Urantien — Issue 24 — Winter 2002 — Contents	Le Lien Urantien — Numéro 24 — Hiver 2002 — Contenu
The Personality	La Personnalité
If...	Si...
The Providence of God	La Providence de Dieu
Sudden Awakening	Réveil soudain
2003	2003
Le Lien Urantien — Issue 25 — Spring 2003	Le Lien Urantien — Numéro 25 — Printemps 2003
Le Lien Urantien — Issue 25 — Spring 2003 — Contents	Le Lien Urantien — Numéro 25 — Printemps 2003 — Contenu
Approaching some scientific aspects of The Urantia Book	Approche de quelques aspects scientifiques du Livre d'Urantia
Ignorance	Ignorance
Story of a visit	Récit d'une visite
Sudden awakening (second part)	Réveil soudain (deuxième partie)
Words of love	Mots d'amour
Le Lien Urantien — Issue 26 — Summer 2003	Le Lien Urantien — Numéro 26 — Été 2003
Le Lien Urantien — Issue 26 — Summer 2003 — Contents	Le Lien Urantien — Numéro 26 — Été 2003 — Contenu
Material Time — Morontia Time — Spiritual Time - “The Importance of Time According to The Urantia Book”	Le temps matériel — le temps morontiel — le temps spirituel -« l'importance du temps selon le livre d’Urantia »
A Little Personal Theory on the Proof of God's Existence	Petite théorie personnelle sur la preuve de l'existence de Dieu
First Meeting. Story of a Visit	Première réunion. Récit d'une visite
“The Will of God”: Elucubration or God, My Best Friend?!	« La volonté de Dieu » : élucubration ou Dieu, mon meilleur copain ?!
Le Lien Urantien — Issue 27 — Autumn 2003	Le Lien Urantien — Numéro 27 — Automne 2003
Le Lien Urantien — Issue 27 — Autumn 2003 — Contents	Le Lien Urantien — Numéro 27 — Automne 2003 — Contenu
Material Time — Morontia Time — Spiritual Time - “The Importance of Time According to The Urantia Book” (2)	Le temps matériel — le temps morontiel — le temps spirituel -« l'importance du temps selon le livre d’Urantia » (2)
The Hidden Version of Part IV of The Urantia Book	La version cachée de la quatrième partie du Livre d'Urantia
Reincarnation, Truth or Superstition?	Réincarnation, vérité ou superstition ?
Doubt and Doubts	Doute et doutes
Doubt	Doute
August 21, 2003	21 août 2003
Le Lien Urantien — Issue 28 — Winter 2003	Le Lien Urantien — Numéro 28 — Hiver 2003
Le Lien Urantien — Issue 28 — Winter 2003 — Contents	Le Lien Urantien — Numéro 28 — Hiver 2003 — Contenu
Carolyn Kendall talks about history the Time factor	Carolyn Kendall parle d'histoire le facteur Temps
The art of living — according to Jesus and the Urantia Book	L'art de vivre — selon Jésus et le livre d'Urantia
The 100 Factor or the 757,575 years that separate us (maybe) from Paradise	Le Facteur 100 ou les 757 575 ans qui nous séparent (peut être) du Paradis
Humor, laughter and smiles in the Urantia Book	L'humour, le rire et le sourire dans le Livre d'Urantia
Report of the Armeau meeting: November 2003	Compte-rendu de la réunion d'Armeau :novembre 2003
Relaxation corner: I am no longer afraid	Coin détente : Je n'ai plus peur
Testimony	Témoignage
2004	2004
Le Lien Urantien — Issue 29 — Spring 2004	Le Lien Urantien — Numéro 29 — Printemps 2004
Le Lien Urantien — Issue 29 — Spring 2004 — Contents	Le Lien Urantien — Numéro 29 — Printemps 2004 — Contenu
What are “black holes”?	Qu'est-ce que les « trous noirs »?
Triptych	Triptyque
Reflections	Réflexions
Should we juggle with numbers?	Doit-on jongler avec les nombres ?
For a friend	Pour un ami
Other eyes, other skies...	D'autres yeux, d'autres cieux...
A life must die	Une vie doit mourir
Love dissolves differences...	L'amour dissout les différences...
Le Lien Urantien — Issue 30 — Summer 2004	Le Lien Urantien — Numéro 30 — Été 2004
Le Lien Urantien — Issue 30 — Summer 2004 — Contents	Le Lien Urantien — Numéro 30 — Été 2004 — Contenu
The great challenge	Le grand défi
Beauty	La beauté
From matter to Spirit via the mind	De la matière à l'Esprit en passant par le mental
Sharing The Urantia Book with young teens.	Partage du Livre d'Urantia avec de jeunes Ados.
Form and Resurrection	Forme et résurrection
Le Lien Urantien — Issue 31 — Autumn 2004	Le Lien Urantien — Numéro 31 — Automne 2004
Le Lien Urantien — Issue 31 — Autumn 2004 — Contents	Le Lien Urantien — Numéro 31 — Automne 2004 — Contenu
Cosmic Consciousness	La Conscience cosmique
Discernment and Free Will	Discernement et libre arbitre
Bridges, walkways and rope ladders	Ponts, passerelles et échelles de corde
Nostalgia	Nostalgie
Magic	Magie
Le Lien Urantien — Issue 32 — Winter 2004	Le Lien Urantien — Numéro 32 — Hiver 2004
Le Lien Urantien — Issue 32 — Winter 2004 — Contents	Le Lien Urantien — Numéro 32 — Hiver 2004 — Contenu
Becoming What I AM	Devenir ce que JE SUIS
Reason and Faith	La raison et la foi
Hasty Judgment	Jugement hâtif
Where Metaphysics Totally Fails	Là où la métaphysique échoue totalement
Testimony: Diamond Wedding or Smiling Philosophy of Serene Octogenarians	Témoignage : Noces de Diamant ou Philosophie souriante d'octogénaires sereins
Absence	Absence
2005	2005
Le Lien Urantien — Issue 33 — Spring 2005	Le Lien Urantien — Numéro 33 — Printemps 2005
Le Lien Urantien — Issue 33 — Spring 2005 — Contents	Le Lien Urantien — Numéro 33 — Printemps 2005 — Contenu
Proposal of a reading method	Proposition d'une méthode de lecture
The friend of God	L'ami de Dieu
The search for God is the search for his three values: truth beauty goodness	La recherche de Dieu est la recherche de ses trois valeurs : vérité beauté bonté
Thought	Pensée
Le Lien Urantien — Issue 34 — Summer 2005	Le Lien Urantien — Numéro 34 — Été 2005
Le Lien Urantien — Issue 34 — Summer 2005 — Contents	Le Lien Urantien — Numéro 34 — Été 2005 — Contenu
Contact	Contact
Theoretical Explanation of Creation	Explication théorique de la création
God the Absolute	Dieu l'absolu
Pentecost of the Year 30: Forty or Fifty Days After Easter?	Pentecôte de l'an 30 : quarante ou cinquante jours après la Pâques ?
The Impossible Dialogue with Fundamentalists	L'impossible dialogue avec des fondamentalistes
Le Lien Urantien — Issue 35 — Autumn/Winter 2005	Le Lien Urantien — Numéro 35 — Automne/Hiver 2005
Le Lien Urantien — Issue 35 — Autumn/Winter 2005 — Contents	Le Lien Urantien — Numéro 35 — Automne/Hiver 2005 — Contenu
Understanding your neighbor	Comprendre son prochain
Science, philosophy, religion and revelation	Science, philosophie, religion et révélation
From matter to spirit via the mind	De la matière à l'esprit en passant par le mental
For a friend	Pour un ami
Serenity	Sérénité
2006	2006
Le Lien Urantien — Issue 36 — Spring 2006	Le Lien Urantien — Numéro 36 — Printemps 2006
Le Lien Urantien — Issue 36 — Spring 2006 — Contents	Le Lien Urantien — Numéro 36 — Printemps 2006 — Contenu
Spiritual Attraction	Attirance spirituelle
The Trinity	La Trinité
The Urantia Movement	Le mouvement urantien
Spiritual Sovereignty	Souveraineté spirituelle
Who Am I? — Where Do We Come From? — Where Are We Going? What Is the Purpose of Life?	Qui suis-je ? — D'où venons-nous ? — Où allons — nous ? Quel est le but de la vie ?
Le Lien Urantien — Issue 37 — Autumn 2006	Le Lien Urantien — Numéro 37 — Automne 2006
Le Lien Urantien — Issue 37 — Autumn 2006 — Contents	Le Lien Urantien — Numéro 37 — Automne 2006 — Contenu
The President's Word	Le mot du Président
Knowledge and Truth	Connaissance et vérité
Dual Nature	Double nature
General Semantics and The Urantia Book	La sémantique générale et le Livre d'Urantia
“Faith”	« La Foi »
ME!	MOI!
When He Passed By	Quand il passait
The Game of “I Find Myself”	Le jeu du « Je me retrouve »
Report of the Meeting at the Grand Seminary of Lorraine	Compte rendu de la réunion au Grand séminaire de Lorraine
Le Lien Urantien — Issue 38 — Winter 2006	Le Lien Urantien — Numéro 38 — Hiver 2006
Le Lien Urantien — Issue 38 — Winter 2006 — Contents	Le Lien Urantien — Numéro 38 — Hiver 2006 — Contenu
The President's Word	Le mot du Président
Essays to explain the concept of living truth	Essais d'explication du concept de la vérité vivante
Humans and their double	L'humain et son double
Worship God? An invitation to travel outside of space-time	Adorer Dieu ? une invitation au voyage hors de l' espace-temps
A Reader's Experience, an experience to draw from	Une Expérience de lecteur, une experience a tirer
Testimony on the meeting in Armeau	Témoignage sur la rencontre à Armeau
Sharing on spiritual teachings and leaders	Partage sur les enseignements et dirigeants spirituels
Report of the Armeau meeting	Rapport de la réunion d'Armeau
2007	2007
Le Lien Urantien — Issue 39 — Summer 2007	Le Lien Urantien — Numéro 39 — Été 2007
Le Lien Urantien — Issue 39 — Summer 2007 — Contents	Le Lien Urantien — Numéro 39 — Été 2007 — Contenu
A Word from the President	Le mot du Président
Spiritual Wisdom and Genetic Knowledge	Sagesse spirituelle et connaissance génétique
Brother Dominique's Corner	Le coin de Frère Dominique
Genese	Genese
The Tulip	La Tulipe
The Story of Life	L'histoire de la vie
Memories Memories	Souvenirs Souvenirs
Annual Meeting at Notre Dame des Lumières	Rencontre annuelle à Notre Dame des Lumières
Reflections from Georges & Marlene	Réflexions de Georges & Marlene
Le Lien Urantien — Issue 40 — Autumn 2007	Le Lien Urantien — Numéro 40 — Automne 2007
Le Lien Urantien — Issue 40 — Autumn 2007 — Contents	Le Lien Urantien — Numéro 40 — Automne 2007 — Contenu
The President's Word	Le mot du Président
The Biological Improvement of Humanity	L'amélioration biologique de l'humanité
Some Thoughts and Questions of Me	Quelques Réflexions et Interrogations de Moi
After the Death of His Life Companion	Après la mort de son compagnon de vie
Thank You, My God	Merci mon Dieu
Brother Dominique's Corner	Le coin de Frère Dominique
Michael's Birthday of August 21, 2007	Anniversaire de Micaël du 21 août 2007
Little Morontia Bubbles	Petites bulles morontielles
Urantia Book Study Group June 1979 — Letter No. 2	Groupe d'Etude du Livre d'Urantia Juin 1979 — Lettre nº 2
Le Lien Urantien — Issue 41 — Winter 2007	Le Lien Urantien — Numéro 41 — Hiver 2007
Le Lien Urantien — Issue 41 — Winter 2007 — Contents	Le Lien Urantien — Numéro 41 — Hiver 2007 — Contenu
The President's Word	Le mot du Président
Presentation of the Book	Présentation du Livre
A Little Reflection on the Power of Loving (Part 1)	Petite réflexion sur la puissance d'aimer (1ère partie)
Story: The Barn	Conte : La Grange
AFLLU Autumn Meeting in AIX-LES-BAINS	Rencontre d'automne de l'AFLLU à AIX-LES-BAINS
Reflection on Infidelity	Réflexion sur l'infidélité
Trinity of Supremacy	Trinité de Suprématie
Brother Dominique's Corner	Le coin de Frère Dominique
Georges & Marlène's Thoughts	Réflexions de Georges & Marlène
2008	2008
Le Lien Urantien — Issue 42 — Spring 2008	Le Lien Urantien — Numéro 42 — Printemps 2008
Le Lien Urantien — Issue 42 — Spring 2008 — Contents	Le Lien Urantien — Numéro 42 — Printemps 2008 — Contenu
The President's Word	Le mot du Président
Presentation of the Book	Présentation du Livre
A Little Reflection on the Power of Loving (Part 2)	Petite réflexion sur la puissance d'aimer (2ème partie)
The 7 Jubilees	Les 7 jubilés
The Book and its Sources	Le Livre et ses sources
The Winter Wind	Le vent d'hiver
The Essentials	L'essentiel
Brother Dominique's Corner	Le coin de Frère Dominique
Le Lien Urantien — Issue 43 — Summer 2008	Le Lien Urantien — Numéro 43 — Été 2008
Le Lien Urantien — Issue 43 — Summer 2008 — Contents	Le Lien Urantien — Numéro 43 — Été 2008 — Contenu
Prelude: The President's Word	Prélude: Le Mot du Président
Editorial	Edito
Le Point: Dinard	Le Point: Dinard
National Meeting from May 22 to May 25	Rencontre nationale du 22 mai au 25 mai
Study: Agondontarians	Etude: Agondontaires
On the feeling of existing	Sur le sentiment d'exister
Le Lien Urantien — Issue 44 — Autumn 2008	Le Lien Urantien — Numéro 44 — Automne 2008
Le Lien Urantien — Issue 44 — Autumn 2008 — Contents	Le Lien Urantien — Numéro 44 — Automne 2008 — Contenu
The Guest	L'invité
Spring: Study of the Future	Printemps : étude du futur
Words of Life	Paroles de Vie
How Beautiful You Have Made the Earth!	Que belle vous avez fait la terre!
Messenger Molecules	Molécules messagères
Le Lien Urantien — Issue 45 — Winter 2008	Le Lien Urantien — Numéro 45 — Hiver 2008
Le Lien Urantien — Issue 45 — Winter 2008 — Contents	Le Lien Urantien — Numéro 45 — Hiver 2008 — Contenu
Editorial: It is written!	Edito : C'est écrit !
Appellations of the Mystery Monitor	Appellations du Moniteur de Mystère
The guest	L'invitée
How big is Paradise	Combien grand le Paradis
The Self and the Ego	Le Moi et l'Ego
The Parable of the Oyster	La Parabole de l`Huître
Suresnes 21-23 November 08	Suresnes 21-23 novembre 08
Strands of Life	Brins de Vie
A day in Suresnes	Une journée à Suresnes
Other Sheep	Autres Brebis
In the spiritual life	Dans la vie spirituelle
2009	2009
Le Lien Urantien — Issue 46 — Spring 2009	Le Lien Urantien — Numéro 46 — Printemps 2009
Le Lien Urantien — Issue 46 — Spring 2009 — Contents	Le Lien Urantien — Numéro 46 — Printemps 2009 — Contenu
The President's Note	Le Billet du Président
Guest: Dutch Urantia Association	L'invitée : Association Urantia Neerlandaise
Levels of Realization	Niveaux de réalisation
Personal Growth - Arrival Mansion Worlds	Croissance Personnelle - Arrivée Mondes Maisons
The Ego and the Self	L'Ego et le Moi
Guten Tag Urantia!	Guten Tag Urantia !
Make Yourself	Fais-toi
Blue Eyes	Les Yeux Bleus
Get Your Calculators	A vos Calculettes
Self-Healing	Auto - Guérison
Brother Dominique's Little Corner	P’tit Coin de Frère Dominique
Le Lien Urantien — Issue 47 — Summer 2009	Le Lien Urantien — Numéro 47 — Été 2009
Le Lien Urantien — Issue 47 — Summer 2009 — Contents	Le Lien Urantien — Numéro 47 — Été 2009 — Contenu
The President's Note	Le Billet du Président
Guest: Chilean Urantia Association	L'invité : Association Urantia Chilienne
Human Philosophy and Mota	Philosophie humaine et mota
Meeting of 21.02.09	Rencontre du 21.02.09
Tolerance	La Tolérance
Of the Word	Du Verbe
Love	Amour
Having Wheat	Avoir du Blé
A Thousand Thanks	Mille mercis
Doing the Father's Will	Faire la volonté du Père
Brother Dominique's Little Corner	P’tit Coin de Frère Dominique
Le Lien Urantien — Issue 48 — Autumn 2009	Le Lien Urantien — Numéro 48 — Automne 2009
Le Lien Urantien — Issue 48 — Autumn 2009 — Contents	Le Lien Urantien — Numéro 48 — Automne 2009 — Contenu
The Guest: The Extraterrestrial Usain Bolt	L’Invité: L’extraterrestre Usain Bolt
Human Philosophy and Mota (2)	Philosophie humaine et mota (2)
The Osteoclast	L’ostéoclaste
Happiness	Le bonheur
Serenity	La sérénité
Love and Respect for Life	Amour et respect de la vie
Rodan's Papers	Fascicules de Rodan
The Sailboat	Le Voilier
When the Wind Blows at Night...	Quand le vent souffle la nuit...
Brother Dominique's Little Corner	P’tit Coin de Frère Dominique
Le Lien Urantien — Issue 49 — Winter 2009	Le Lien Urantien — Numéro 49 — Hiver 2009
Le Lien Urantien — Issue 49 — Winter 2009 — Contents	Le Lien Urantien — Numéro 49 — Hiver 2009 — Contenu
The Living Water of UB	L’Eau Vive du LU
The President’s Note	Le billet du Président
Jean-François and the Seahorse	Jean-François et l’hippocampe
National Meeting at Notre Dame de Lumières	Rencontre nationale à Notre Dame de Lumières
Indefinite Pronouns	Les pronoms indéfinis
Uncertainty and Security	Incertitude et sécurité
God, the Consumer of Universal Destiny	Dieu, le Consommateur de la Destinée Universelle
The Apostles – The Lion	Les Apôtres – Le Lion
Our Emotions	Nos émotions
Gift of Love	Don de l’Amour
Brother Dominique’s Little Corner	P’tit Coin de Frère Dominique
2010	2010
Le Lien Urantien — Issue 50 — Spring 2010	Le Lien Urantien — Numéro 50 — Printemps 2010
Le Lien Urantien — Issue 50 — Spring 2010 — Contents	Le Lien Urantien — Numéro 50 — Printemps 2010 — Contenu
Prayer	La Prière
Malek Jân Ne’mati	Malek Jân Ne’mati
The “Our Father”	Le « Notre Père»
Maxi Quiz No. 1 Questions	Quiz maxien n°1 Les questions
Study of Prayers	Étude des prières
The Presence of God	La Présence de Dieu
Gift of Love (2)	Don de l’Amour (2)
The Dual Nature	La double nature
Maxi Quiz No. 1 Answers	Quiz maxien n°1 Les réponses
Brother Dom’s Little Corner	P’tit Coin de Frère Dom’
Le Lien Urantien — Issue 51 — Summer 2010	Le Lien Urantien — Numéro 51 — Été 2010
Le Lien Urantien — Issue 51 — Summer 2010 — Contents	Le Lien Urantien — Numéro 51 — Été 2010 — Contenu
Gratitude	Reconnaissance
Bahaism	Le Bahaïsme
The “Our Father”	Le « Notre Père»
Maxi Quiz No. 2 Questions	Quiz maxien n°2 Les questions
The Philosophy That Saves	La philosophie qui sauve
Jesus’ Attitude Toward Women	L’attitude de Jésus envers les femmes
Light, Light!	Léger, léger !
Meeting of 06.03.2010	Rencontre du 06.03.2010
Trust	La confiance
Chales	Chales
Hermeticism and Eugenics	Hermétisme et Eugénisme
Lyrical Pages	Pages Lyriques
Being right or being happy	Avoir raison ou être heureux
Maxi Quiz n°2 The answers	Quiz maxien n°2 Les réponses
Le Lien Urantien — Issue 52 — Autumn 2010	Le Lien Urantien — Numéro 52 — Automne 2010
Le Lien Urantien — Issue 52 — Autumn 2010 — Contents	Le Lien Urantien — Numéro 52 — Automne 2010 — Contenu
Humor	Humour
Elisabeth Sombart, the pianist of the Angels	Elisabeth Sombart, la pianniste des Anges
Personality	La personnalité
Maxi Quiz n°3 The questions	Quiz maxien n°3 Les questions
Being Young	Etre Jeune
Reclosed	Recloses
My life in Paradise	Ma vie au Paradis
God's CV	Le CV de Dieu
Photos of 21.10.2010 C° Eliane	Photos du 21.10.2010 C° Eliane
Reincarnation	La réincarnation
My garden	Mon jardin
Lyrical Pages	Pages Lyriques
Success, instructions for use	Réussite, mode d’emploi
Maxi Quiz n°3 The answers	Quiz maxien n°3 Les réponses
Brother Dom's Little Corner	P’tit Coin de Frère Dom’
Le Lien Urantien — Issue 53 — Winter 2010	Le Lien Urantien — Numéro 53 — Hiver 2010
Le Lien Urantien — Issue 53 — Winter 2010 — Contents	Le Lien Urantien — Numéro 53 — Hiver 2010 — Contenu
United around a BOOK	Unis autour d’un LIVRE
Brotherhood according to Theosophy	La fraternité selon la Téosophie
Are we ambassadors?	Sommes-nous des ambassadeurs ?
The World of Mansions	Le Monde des Maisons
Maxi Quiz No. 4 The Questions	Quiz maxien n°4 Les questions
Prayers	Prières
Poetry	Poésie
The 6th Adjutant Mental Spirit	Le 6ème esprit mental adjuvat
Comic Strip	BD humoristique
Power Directors and Transcendentals	Directeurs de Pouvoir et transcendantaux
Gliese 581	Gliese 581
Belgium 08/21/2010	Belgique le 21/08/2010
RANTOWOC	RANTOWOC
Ganid	Ganid
Traits of Humor	Traits d’humour
These Absurd Theories	Ces théories absurdes
Maxi Quiz No. 4 The Answers	Quiz maxien n°4 Les réponses
Brother Dom’s Little Corner	P’tit Coin de Frère Dom’
2011	2011
Le Lien Urantien — Issue 54 — Spring 2011	Le Lien Urantien — Numéro 54 — Printemps 2011
Le Lien Urantien — Issue 54 — Spring 2011 — Contents	Le Lien Urantien — Numéro 54 — Printemps 2011 — Contenu
The Eternal	L’Eternel
Being Effective	Être efficace
The Deity	La Déité
Semi 2	Semi 2
Maxi Quiz #5 Questions	Quiz maxien n°5 Les questions
Twilight	Crépusculaire
Forgive	Pardonner
Forgive	Pardonner
The Praise of Fatigue	L’éloge de la fatigue
On Understanding The Urantia Book	De la compréhension du Livre d’Urantia
The Resurrection of Ganid	La résurrection de Ganid
Universal Levels of Reality	Niveaux Universels de Réalité
The Little Voice	La Petite Voix
Excerpts from The Life of the Masters	Extraits de La Vie des Maîtres
The Feminine Nature	La Nature Féminine
Maxi Quiz #5 Answers	Quiz maxien n°5 Les réponses
Brother Dom’s Little Corner	P’tit Coin de Frère Dom’
Le Lien Urantien — Issue 55 — Summer 2011	Le Lien Urantien — Numéro 55 — Été 2011
Le Lien Urantien — Issue 55 — Summer 2011 — Contents	Le Lien Urantien — Numéro 55 — Été 2011 — Contenu
Paul and the Eternal Feminine	Paul et l’Éternel Féminin
The Heavenly Funerals	Les Funérailles Célestes
In the Footsteps of Paul	Sur les traces de Paul
Light 05-08 May 2011	Lumière 05-08 mai 2011
Maxi Quiz #6 Questions	Quiz maxien n°6 Les questions
The Immanence of God in Me	L’immanence de Dieu en moi
The Blue Book	Le Livre Bleu
The WOMAN	La F E M M E
The Year 1955, The Urantia Book….and the Poet	L’année 1955, le Livre d’Urantia….et le poète
Race to the Other Earth	Course à l’autre Terre
Light 04-06 May 2011 (01)	Lumière 04-06 mai 2011 (01)
And God created woman...	Et Dieu créa la femme...
Theosophical Review	Revue Théosophique
Maxi Quiz No. 6 The answers	Quiz maxien n°6 Les réponses
Brother Dom’s Little Corner	P’tit Coin de Frère Dom’
Le Lien Urantien — Issue 56 — Autumn 2011	Le Lien Urantien — Numéro 56 — Automne 2011
Le Lien Urantien — Issue 56 — Autumn 2011 — Contents	Le Lien Urantien — Numéro 56 — Automne 2011 — Contenu
Travel Words	Mots de Voyage
Chicago, Paul and the Eternal Feminine	Chicago, Paul et l’Éternel Féminin
The Little Beatitudes	Les petites Béatitudes
Chicago Symposium 2011	Symposium de Chicago 2011
Maxi Quiz No. 7 The questions	Quiz Maxien n°7 Les questions
You have value in my eyes	Vous avez de la valeur à mes yeux
Ancient Prayers	Prières Anciennes
Interview with God	Entretien avec Dieu
A marvelous assembly	Une assemblée merveilleuse
The hymn to love	L’hymne à l’amour
The Universe and Nature, a mechanism of laws	L’Univers et la Nature, un mécanisme de lois
The Woman	La Femme
Michael’s Birthday	Anniversaire de Micaël
Absolutely nothing and Me	Absolument rien et Moi
Praise of the woman	Éloge de la femme
Jesus and women	Jésus et les femmes
The return of the goddess	Le retour de la déesse
Chicago Symposium 2011 - Photos	Symposium de Chicago 2011 - Photos
The Tupperware Saga	La Saga Tupperware
Maxi Quiz No. 7 The answers	Quiz Maxien n°7 Les réponses
Caminante, no hay camino	Caminante, no hay camino
Le Lien Urantien — Issue 57 — Winter 2011	Le Lien Urantien — Numéro 57 — Hiver 2011
Le Lien Urantien — Issue 57 — Winter 2011 — Contents	Le Lien Urantien — Numéro 57 — Hiver 2011 — Contenu
The President’s note	Le billet du Président
Paul and the Eternal Feminine (2)	Paul et l’Éternel Féminin (2)
Marie	Marie
Maxi Quiz n°8 The questions	Quiz Maxien n°8 Les questions
Exoplanets	Les exoplanètes
The Seven Fundamental Realities (what is given)	Les Sept Réalités Fondamentales (ce qui est donné)
Genesis- Zizi - Computer	Genèse- Zizi - Ordinateur
The hymn to love (2)	L’hymne à l’amour (2)
The Journey of the Fathers	Le Voyage des Pères
Emergence - Pro Machiventa	Émergence - Pro Machiventa
Domaine de Châles	Domaine de Châles
The Etern-Feminine Wing	L’Etern-Aile Féminine
The Higgs boson	Le boson de Higgs
The Life of the Masters (extracts)	La Vie des Maîtres (extraits)
Quiz Maxien n°8 The answers	Quiz Maxien n°8 Les réponses
Little Corner of Brother Dom’	P’tit Coin de Frère Dom’
2012	2012
Le Lien Urantien — Issue 58 — Spring 2012	Le Lien Urantien — Numéro 58 — Printemps 2012
Le Lien Urantien — Issue 58 — Spring 2012 — Contents	Le Lien Urantien — Numéro 58 — Printemps 2012 — Contenu
The President's Note: Reunion	Le billet du Président : Retrouvailles
Paul and the Eternal Feminine (3)	Paul et l’Éternel Féminin (3)
Philosophy Fundamental Concepts	Philosophie Concepts fondamentaux
Maxien Quiz No. 9 The Questions	Quiz Maxien n°9 Les questions
Artistic Scoop Free Interpretation "Adam-Eve"	Scoop artistique Interprétation libre «Adam-Ève»
The Seven Fundamental Realities (what is given) Part II	Les Sept Réalités Fondamentales (ce qui est donné) partie II
I have only you my "Father"	Je n’ai que vous mon «Père»
Perpetual Calendar	Calendrier perpétuel
The Sex of Angels	Le sexe des Anges
Celebrating Life	Célébrer la vie
The Impatient	Les Impatients
Tribute to François Dupont	Hommage à François Dupont
My Attitude	Mon attitude
Everything Comes in Its Time	Tout vient en son temps
The Prayer of Consent	La Prière de Consentement
The First Sentence of The Urantia Book	La première phrase du Livre d’Urantia
Maxien Quiz No. 9 The Answers	Quiz Maxien n°9 Les réponses
Brother Dom's Little Corner	P’tit Coin de Frère Dom’
Le Lien Urantien — Issue 59 — Summer 2012	Le Lien Urantien — Numéro 59 — Été 2012
Le Lien Urantien — Issue 59 — Summer 2012 — Contents	Le Lien Urantien — Numéro 59 — Été 2012 — Contenu
The President's Note: Reunion	Le billet du Président : Retrouvailles
La Neylière and Psychic Circles	La Neylière et les cercles psychiques
Being Well	Être Bien
Self-Esteem	Estime de soi
Maxien Quiz No. 10 The Questions	Quiz Maxien n°10 Les questions
The Seven Fundamental Realities (what is given) Part III	Les Sept Réalités Fondamentales (ce qui est donné) partie III
Selected Excerpts	Morceaux choisis
La Neylière 2012	La Neylière 2012
Trust	La Confiance
The Breath of God	Le Souffle de Dieu
Self-esteem I	L’estime de soi I
Empathy and Leadership	Empathie et Leadership
Quiz Maxien n°10 The answers	Quiz Maxien n°10 Les réponses
P’tit Coin de Frère Dom’	P’tit Coin de Frère Dom’
Le Lien Urantien — Issue 60 — Autumn 2012	Le Lien Urantien — Numéro 60 — Automne 2012
Le Lien Urantien — Issue 60 — Autumn 2012 — Contents	Le Lien Urantien — Numéro 60 — Automne 2012 — Contenu
The President’s note: Re	Le billet du Président : Re
Artisans of Peace	Artisans de Paix
Suicide	Le suicide
Peace Initiatives	Initiatives de Paix
Quiz Maxien n°11 The questions	Quiz Maxien n°11 Les questions
The Seven Fundamental Realities part IV	Les Sept Réalités Fondamentales partie IV
Saint Philippe Néri	Saint Philippe Néri
An evening at the Neylière	Une soirée à la Neylière
The art of blessing	L’art de bénir
Some passages from LU	Quelques passages du LU
In the footsteps of Jesus (fiction)	Sur les pas de Jésus (fiction)
Self-esteem II	L’estime de soi II
Belgian meeting August 19, 2012	Réunion belge 19 août 2012
History	Histoire
Quiz Maxien n°11 The answers	Quiz Maxien n°11 Les réponses
P’tit Coin de Frère Dom’	P’tit Coin de Frère Dom’
Le Lien Urantien — Issue 61 — Winter 2012	Le Lien Urantien — Numéro 61 — Hiver 2012
Le Lien Urantien — Issue 61 — Winter 2012 — Contents	Le Lien Urantien — Numéro 61 — Hiver 2012 — Contenu
The President’s note: Rapprochement	Le billet du Président : Rapprochement
Knowledge and Consciousness!	Savoir et Conscience !
Free Will	Le Libre Arbitre
When I Can Say...	Quand je pourrai dire...
Quiz Maxien n°12 The Questions	Quiz Maxien n°12 Les questions
The Seven Fundamental Realities Part V	Les Sept Réalités Fondamentales partie V
Puns on Christianity	Jeux de mots sur le Christianisme
The Day When	Le Jour Où
Conscience	La Conscience
Quiz Maxien n°11 The Answers 8 to 18 (updated)	Quiz Maxien n°11 Les réponses 8 à 18 (remise à jour)
I Would Like to Dress Myself in God	Je voudrais m'habiller de Dieu
Self-Esteem III	L’estime de soi III
To Ask for Good Humor	Pour demander la bonne humeur
Quiz Maxien n°12 The Answers	Quiz Maxien n°12 Les réponses
Brother Dom’s Little Corner	P’tit Coin de Frère Dom’
2013	2013
Le Lien Urantien — Issue 62 — Spring 2013	Le Lien Urantien — Numéro 62 — Printemps 2013
Le Lien Urantien — Issue 62 — Spring 2013 — Contents	Le Lien Urantien — Numéro 62 — Printemps 2013 — Contenu
The President's Note: Our Meeting Groups	Le billet du Président : Nos groupes de rencontre
Love, Gratitude and Light	Amour, Gratitude et Lumière
On Love I	Sur l'Amour I
The Sower	Le Semeur
Maxian Quiz No. 13 The Questions	Quiz Maxien n°13 Les questions
The Seven Fundamental Realities VI	Les Sept Réalités Fondamentales VI
Jesus' Report Card	Bulletin de notes de Jésus
In the Light	A la lumière
The Agondontarians	Les Agondontaires
Love: The Heart of God	Amour : Le Cœur De Dieu
Pontius Pilate	Ponce Pilate
GRATITUDE	LA GRATITUDE
Morning Prayer	Prière ... du Matin
Our Christian Civilization is in Danger	Notre civilisation chrétienne est en danger
Maxian Quiz No. 13 The Answers	Quiz Maxien n°13 Les réponses
Brother Dom's Little Corner: The Part of the Dream	P’tit Coin de Frère Dom’: La Part Du Rêve
Le Lien Urantien — Issue 63 — Summer 2013	Le Lien Urantien — Numéro 63 — Été 2013
Le Lien Urantien — Issue 63 — Summer 2013 — Contents	Le Lien Urantien — Numéro 63 — Été 2013 — Contenu
Abundance of Articles	Abondance d'articles
On Love II	Sur l'Amour II
God gives the Adjuster	Dieu donné l’Ajusteur
Maxian Quiz No. 13 The Questions	Quiz Maxien n°13 Les questions
The Seven Fundamental Realities VII	Les Sept Réalités Fondamentales VII
Pontius Pilate (Part 2)	Ponce Pilate (2ème volet)
Being Born of Spirit	Naître d'esprit
The Reality of Personality	La Réalité de la Personnalité
Causes, Effects	Les causes, les effets
Deity - Divinity	Déité - Divinité
Rules for Being Human	Règles pour être humain
Gay Marriage	Mariage Gay
Maxian Quiz No. 13 The Answers	Quiz Maxien n°13 Les réponses
Brother Dom's Little Corner Dom’ One Word!	P’tit Coin de Frère Dom’ Un seul Mot !
Le Lien Urantien — Issue 64 — Autumn 2013	Le Lien Urantien — Numéro 64 — Automne 2013
Le Lien Urantien — Issue 64 — Autumn 2013 — Contents	Le Lien Urantien — Numéro 64 — Automne 2013 — Contenu
The President’s Note Salon	Le billet du Président Salon
Love, Gratitude and Light	Amour, Gratitude et Lumière
On Love III	Sur l'Amour III
Quiz Maxien n°15 The questions	Quiz Maxien n°15 Les questions
The Seven Fundamental Realities VII	Les Sept Réalités Fondamentales VII
The Reality of Personality II	La Réalité de la Personnalité II
Awakened to the fullness of life	Éveillé à la plénitude de la vie
The causes, the effects II	Les causes, les effets II
The fairy	La fée
Quiz Maxien n°15 The answers	Quiz Maxien n°15 Les réponses
Brother Dom’s Little Corner The Truth	P’tit Coin de Frère Dom’ La Vérité
Le Lien Urantien — Issue 65 — Winter 2013	Le Lien Urantien — Numéro 65 — Hiver 2013
Le Lien Urantien — Issue 65 — Winter 2013 — Contents	Le Lien Urantien — Numéro 65 — Hiver 2013 — Contenu
The President’s Note Lumière	Le billet du Président Lumière
Love, again and again	Amour, encore et toujours
On Love IV	Sur l'Amour IV
Quiz Maxien n°16 The questions	Quiz Maxien n°16 Les questions
The Seven Fundamental Realities VIII	Les Sept Réalités Fondamentales VIII
The Power of Love	La Puissance de l'Amour
Life	La Vie
The Lotus Temple	Le Temple du Lotus
War Doctor	Médecin de guerre
The causes, the effects III	Les causes, les effets III
Death does not exist	La mort n'existe pas
Quiz Maxien n°16 The answers	Quiz Maxien n°16 Les réponses
Brother Dom’s Little Corner Reading	P’tit Coin de Frère Dom’ Lecture
2014	2014
Le Lien Urantien — Issue 66 — Spring 2014	Le Lien Urantien — Numéro 66 — Printemps 2014
Le Lien Urantien — Issue 66 — Spring 2014 — Contents	Le Lien Urantien — Numéro 66 — Printemps 2014 — Contenu
The President's note General Appeal	Le billet du Président Appel Général
Traffic jam	Embouteillage
On Love V	Sur l'Amour V
Quiz Maxien n°17 ​​The questions	Quiz Maxien n°17 Les questions 
The Seven Fundamental Realities IX	Les Sept Réalités Fondamentales IX
Wise words (Khalil Gibran)	Paroles sages (Khalil Gibran)
The LU and science	Le LU et la science
The Project of Life	Le Projet de Vie
The Olympic Values	Les Valeurs Olympiques
The causes, the effects IV	Les causes, les effets IV
Quiz Maxien n°17 ​​The answers	Quiz Maxien n°17 Les réponses
Brother Dom's Little Corner The Question!	P’tit Coin de Frère Dom’ La Question !
Le Lien Urantien — Issue 67 — Summer 2014	Le Lien Urantien — Numéro 67 — Été 2014
Le Lien Urantien — Issue 67 — Summer 2014 — Contents	Le Lien Urantien — Numéro 67 — Été 2014 — Contenu
The President's note General Appeal	Le billet du Président Appel Général
Editorial	Edito
Another vision of the universe	Une autre vision de l’univers
Hindu philosophy Principles	Philosophie hindoue Principes
Quiz Maxien n°18 The questions	Quiz Maxien n°18 Les questions
The Seven Fundamental Realities X	Les Sept Réalités Fondamentales X
The Deity	La Déité
Serenity	La Sérénité
Buddhist philosophy Mindfulness	Philosophie bouddhiste La pleine conscience
The consecration of choice	La consécration du choix
Small philosophical survival kit (Alexandra Ahouandjinou)	Petit kit philosophique de survie (Alexandra Ahouandjinou)
In You	En Toi
The causes, the effects V	Les causes, les effets V
Quiz Maxien n°18 The answers	Quiz Maxien n°18 Les réponses
Brother Dom's Little Corner The Question!	P’tit Coin de Frère Dom’ La Question !
Le Lien Urantien — Issue 68 — Autumn 2014	Le Lien Urantien — Numéro 68 — Automne 2014
Le Lien Urantien — Issue 68 — Autumn 2014 — Contents	Le Lien Urantien — Numéro 68 — Automne 2014 — Contenu
The President's Note Summary Jura meeting	Le billet du Président Résumé rencontre jura
Editorial	Edito
Resurrections of mortals after physical death	Résurrections des mortels après la mort physique
Quiz Maxien n°19 The questions	Quiz Maxien n°19 Les questions
The Seven Fundamental Realities XI	Les Sept Réalités Fondamentales XI
The New Jerusalem	La nouvelle Jérusalem
On the revised translation	De la traduction révisée
Prayer	Prière
On freedom and the mode of evolution of civilization	De la liberté et du mode d'évolution de la civilisation
Mandela, Gandhi, M.L. King... And Jesus?	Mandela, Gandhi, M.L. King... Et Jésus ?
Quiz Maxien n°19 The answers	Quiz Maxien n°19 Les réponses
Brother Dom's Little Corner Enjoyment!	P’tit Coin de Frère Dom’ Jouissance !
Le Lien Urantien — Issue 69 — Winter 2014	Le Lien Urantien — Numéro 69 — Hiver 2014
Le Lien Urantien — Issue 69 — Winter 2014 — Contents	Le Lien Urantien — Numéro 69 — Hiver 2014 — Contenu
The President's Note All my best wishes	Le billet du Président Tous mes voeux
To God!	A Dieu !
Quiz Maxien n°20 The questions	Quiz Maxien n°20 Les questions
The Urantia Book in Study Groups	Le Livre d'Urantia dans les Groupes d'Étude
Map of consciousness	Carte de la conscience
The Hummingbird Movement	Le Mouvement Colibris
The Shamengo team	L'équipe Shamengo
Quiz Maxien n°19 The answers	Quiz Maxien n°19 Les réponses
Brother Dom's Little Corner The latest one!	P’tit Coin de Frère Dom’ Le p'tit dernier !
2015	2015
Le Lien Urantien — Issue 70 — Spring 2015	Le Lien Urantien — Numéro 70 — Printemps 2015
Le Lien Urantien — Issue 70 — Spring 2015 — Contents	Le Lien Urantien — Numéro 70 — Printemps 2015 — Contenu
The President's Word	Le mot du président
MAXIEN Quiz #21 and Last — Questions	Quiz MAXIEN n²21 et dernier — Questions
Thoughts on the Art of Merging	Réflexions sur l'art de fusionner
Quiz #21 — Answers	Quiz n 21 — Réponses
Le Lien Urantien — Issue 71 — Autumn 2015	Le Lien Urantien — Numéro 71 — Automne 2015
Le Lien Urantien — Issue 71 — Autumn 2015 — Contents	Le Lien Urantien — Numéro 71 — Automne 2015 — Contenu
Editorial	Éditorial
Editorial Charter of the Link	Charte éditoriale du Lien
Neylière Meeting	Réunion de Neylière
Extraordinary General Assembly	Assemblée Générale Extraordinaire
The Unconscious and the Superconscious	L'inconscient et Le Superconscient
Interactive Study Group	Groupe d'étude interactif
Publications on the Urantia Book	Publications autour du Livre d'Urantia
Le Lien Urantien — Issue 72 — Winter 2015	Le Lien Urantien — Numéro 72 — Hiver 2015
Le Lien Urantien — Issue 72 — Winter 2015 — Contents	Le Lien Urantien — Numéro 72 — Hiver 2015 — Contenu
Editorial	Éditorial
Already 60 Years	Déjà 60 ans
Bill Sadler's Study on Synthesis and Functional Coordination	Étude de Bill Sadler sur la synthèse et la coordination fonctionnelle
International Meeting of Quebec	Rencontre Internationale du Québec
Consciousness — Self-Consciousness & God-Consciousness	Conscience — Conscience de soi & Conscience de Dieu
Visit to Italy	Visite en Italie
Interactive Study Group: Second Series	Groupe d'étude interactif: deuxième série
2016	2016
Le Lien Urantien — Issue 73 — March 2016	Le Lien Urantien — Numéro 73 — Mars 2016
Le Lien Urantien — Issue 73 — March 2016 — Contents	Le Lien Urantien — Numéro 73 — Mars 2016 — Contenu
Editorial	Éditorial
Following the Personality-Power Phenomenon	Suite au phénoméne Personnalité-Pouvoir
The Circuits of the Adjutant Mental Spirits	Les circuits des esprits mentaux adjuvats
Pierrot	Pierrot
History of the French-speaking Movement in Europe	Histoire du mouvement francophone d'Europe
Role of Personality in Our Earthly Experience	Róle de la personnalité dans notre expérience terrestre
Lumen	Lumen
European Conference in Budapest	Conférence Européenne de Budapest
Interactive Study Group: Third Series	Groupe d 'étude interactif: troisiéme série
About the UBIS School	À propos de l'école UBIS
UBIS School Courses for the April Quarter	Cours de l'école UBIS pour le trimestre d'avril
Le Lien Urantien — Issue 74 — June 2016	Le Lien Urantien — Numéro 74 — Juin 2016
Le Lien Urantien — Issue 74 — June 2016 — Contents	Le Lien Urantien — Numéro 74 — Juin 2016 — Contenu
Editorial	Éditorial
Effectively Revealing the Truth	Révéler Effectivement La Vérité
Day and Period	Jour et Période
Another Vision of the Universe	Une Autre Vision De L'univers
Friendship	L'amitié
The Translation of The Urantia Book: State of Play	La traduction de The Urantia Book: État Des Lieux
The Diffusion of the Urantia Book in the World Projection 2015-2100	La Diffusion du Livre d'urantia Dans Le Monde Projection 2015-2100
Interactive Study Group	Groupe d'étude Interactif
Italo-Franco-Swiss Congress	Congrès Italo-Franco-Suisse
Le Lien Urantien — Issue 75 — September 2016	Le Lien Urantien — Numéro 75 — Septembre 2016
Le Lien Urantien — Issue 75 — September 2016 — Contents	Le Lien Urantien — Numéro 75 — Septembre 2016 — Contenu
Editorial	Éditorial
Should We Be Afraid of Islam?	Faut-Il Avoir Peur de L'islam?
Brief Reflections on Time	Brèves Réflexions Sur Le Temps
ABFU Review and Resignation	Bilan et Démission de L'ABFU
Spiritual Love	L'amour Spirituel
Goodbye Bernhard	Au Revoir Bernhard
Chales National Meeting	Réunion Nationale De Chalès
2016 General Assembly Report	Rapport de l'Assemblée Générale 2016
2016 Scientific Symposium in Chicago	Symposium Scientifique 2016 à Chicago
Unicellular Organism The Cambrian Explosion — Nanomachines	Organisme Unicellulaire L'explosion Cambrienne — Nanomachines
Le Lien Urantien — Issue 76 — December 2016	Le Lien Urantien — Numéro 76 — Décembre 2016
Le Lien Urantien — Issue 76 — December 2016 — Contents	Le Lien Urantien — Numéro 76 — Décembre 2016 — Contenu
Editorial	Éditorial
Budapest Conference Report	Compte Rendu Conférence De Budapest
AFLLU 2015 Income Statement	Compte de résultat AFLLU 2015
Meeting in Italy Report	Compte Rendu Rencontre en Italie
Sub-Saharan Africa, Fertile Land for the Teachings of The Urantia Book	L'afrique Subsaharienne, terres fertiles pour les enseignements du Livre d'Urantia
Meeting with Ade Awoyinka	Rencontre avec Ade Awoyinka
Revealed Religion	La Religion Révélée
The Urantia Book in Cameroon	Le Livre d'Urantia au Cameroun
The Urantia Book in Burkina Faso	Le Livre d'Urantia au Burkina Faso
Testimony from Ivory Coast	Témoignage de Côte d'Ivoire
How to Live with an Open Mind	Comment Vivre Avec l'Esprit Ouvert
Implication of Free Will in the Cosmos	Implication du Libre Arbitre Dans Le Cosmos
2017	2017
Le Lien Urantien — Issue 77 — March 2017	Le Lien Urantien — Numéro 77 — Mars 2017
Le Lien Urantien — Issue 77 — March 2017 — Contents	Le Lien Urantien — Numéro 77 — Mars 2017 — Contenu
Editorial	Éditorial
Jesus the Man	Jésus L'homme
Personality Research	Recherches Sur La Personnalité
Parable “In the Way of Jesus”	Parabole «À la façon de Jésus »
From Primitive Prayer to Ethical Prayer: My Personal Experience	De La Prière Primitive À La Prière Éthique : mon expérience personnelle
The Benefits of Group Prayer	Les Bienfaits De La Prière En Groupe
Le Lien Urantien — Issue 78 — June 2017	Le Lien Urantien — Numéro 78 — Juin 2017
Le Lien Urantien — Issue 78 — June 2017 — Contents	Le Lien Urantien — Numéro 78 — Juin 2017 — Contenu
Editorial	Éditorial
The Part Advances the Whole	La Partie Fait Progresser Le Tout
UBIS The Framework of Study — Pedagogy	UBIS Le Cadre D'étude — La Pédagogie
Planetary Overpopulation	Surpopulation Planétaire
The Urantia Book: Corrections to the 1955 Text	The Urantia Book: Corrections au texte de 1955
10th International Conference of the UAI Association — Amsterdam, The Netherlands	10ème Conférence Internationnale De L'association UAI — Amsterdam Pays-Bas
The Spiritual Brain	Le Cerveau Spirituel
Le Lien Urantien — Issue 79 — September 2017	Le Lien Urantien — Numéro 79 — Septembre 2017
Le Lien Urantien — Issue 79 — September 2017 — Contents	Le Lien Urantien — Numéro 79 — Septembre 2017 — Contenu
Editorial	Éditorial
AFLLU Annual Meeting	Réunion annuelle de l'AFLLU
Third Italian Readers’ Congress	Troisième Congrès des lecteurs Italiens
Assembly of God	Assemblée de Dieu
Belief and Faith	La Croyance et la Foi
The UBIS Experience	L'expérience UBIS
Our Educational Imperatives	Nos impératifs d'éducation
Report of the 2017 National Meeting	Compte-Rendu Rencontre Nationnale 2017
Le Lien Urantien — Issue 80 — December 2017	Le Lien Urantien — Numéro 80 — Décembre 2017
Le Lien Urantien — Issue 80 — December 2017 — Contents	Le Lien Urantien — Numéro 80 — Décembre 2017 — Contenu
Editorial	Éditorial
The Universe Is There, Chance Has Nothing to Do With It	L'univers Est Là, Le Hasard N'y Est Pour Rien
The Term “Tension” Can It Enlighten Us on the Trinity	Le Terme « Tension » Peut-Il nous Éclairer sur la Trinité
Questioning God the Sevenfold and Other Definitions	Questionnement sur Dieu le Septuple et autres définitions
Meeting in Italy	Rencontre en Italie
European Meeting in Spain	Rencontre Européenne en Espagne
Toulon Book Fair	Salon du livre de Toulon
2018	2018
Le Lien Urantien — Issue 81 — March 2018	Le Lien Urantien — Numéro 81 — Mars 2018
Le Lien Urantien — Issue 81 — March 2018 — Contents	Le Lien Urantien — Numéro 81 — Mars 2018 — Contenu
Editorial	Éditorial
Jean Royer has left us	Jean Royer nous a quitté
Tribute to Jean Royer	Hommage à Jean Royer
Dear Jean	Cher Jean
Returning to God	Rentrer chez Dieu
My Mind is Pitiful	Mon Mental est Pitoyable
To you, Universal Father, To you, Supreme Mother	À toi, Père Universel, À toi Mère Suprême
Original Concepts	Concepts Originaux
Death	La mort
Le Lien Urantien — Issue 82 — June 2018	Le Lien Urantien — Numéro 82 — Juin 2018
Le Lien Urantien — Issue 82 — June 2018 — Contents	Le Lien Urantien — Numéro 82 — Juin 2018 — Contenu
Editorial	Éditorial
The Truth personally discovered	La Vérité personnelLement découverte
In Search of the Beyond	À La Recherche De L'au-Delả
The Child Jesus and the Doctors of the Law	L'enfant Jésus et les docteurs de la Loi
Being Sensitive to the Personality Circuit	Être sensible au circuit de Personnalité
The Dropper, the Spoon and the Shovel	Le Compte-Goutte, La Cuillère Et La Pelle
The International Meeting in Amsterdam	La rencontre internationale de Amsterdam
IV Congress in Italy	IV Congrès en Italie
Le Lien Urantien — Issue 83 — September 2018	Le Lien Urantien — Numéro 83 — Septembre 2018
Le Lien Urantien — Issue 83 — September 2018 — Contents	Le Lien Urantien — Numéro 83 — Septembre 2018 — Contenu
Editorial	Éditorial
Annual Meeting of the AFLLU	Réunion Annuelle de l’AFLLU
Studying The Urantia Book in Groups	Étude du Livre D’Urantia en Groupe
Prayer in the Form of a Poem	Prière sous forme de Poème
Electrons-Neutrons-Protons	Électrons-Neutrons-Protons
The Birth of the Spirit	La Naissance de l'Esprit
News from Cameroon	Nouvelles du Cameroun
Le Lien Urantien — Issue 84 — December 2018	Le Lien Urantien — Numéro 84 — Décembre 2018
Le Lien Urantien — Issue 84 — December 2018 — Contents	Le Lien Urantien — Numéro 84 — Décembre 2018 — Contenu
Editorial	Éditorial
She Trembles on the Edge	Elle frémit Au Bord
Visit to England	Visite en Angleterre
Visit to Italy	Visite en Italie
All These Trips in Europe	Tous ces voyages en Europe
Our Adventure	Notre Aventure
Studying The Urantia Book. What For?	Étudier le Livre d’Urantia. Pour Quoi Faire?
The Parables	Les Paraboles
2019	2019
Le Lien Urantien — Issue 85 — March 2019	Le Lien Urantien — Numéro 85 — Mars 2019
Le Lien Urantien — Issue 85 — March 2019 — Contents	Le Lien Urantien — Numéro 85 — Mars 2019 — Contenu
Editorial	Éditorial
Lecture in Tallinn	Conférence à Tallinn
One Ridge Can Hide Another	Une Crête Peut En Cacher une autre
The Parables	Les Paraboles
How Long Until Heaven	Combien De Temps Jusqu'au Paradis
Our Adventure	Notre aventure
AFLLU Annual Meeting At Notre Dame des Lumières	Réunion Annuelle De l'AFLLU À Notre Dame des Lumières
Le Lien Urantien — Issue 86 — June 2019	Le Lien Urantien — Numéro 86 — Juin 2019
Le Lien Urantien — Issue 86 — June 2019 — Contents	Le Lien Urantien — Numéro 86 — Juin 2019 — Contenu
Editorial	Éditorial
The Symbolism of Numbers	La Symbolique des nombres
Energy and Food	Énergie Et Nourriture
Time, Energy and Matter	Le Temps, l'Énergie et la Matière
A Love Story	Une Histoire D'amour
The World Cultural Symposium	Le Symposium Culturel Mondial
Our Adventure	Notre Aventure
Le Lien Urantien — Issue 87 — September 2019	Le Lien Urantien — Numéro 87 — Septembre 2019
Le Lien Urantien — Issue 87 — September 2019 — Contents	Le Lien Urantien — Numéro 87 — Septembre 2019 — Contenu
Editorial	Éditorial
Havona and Heaven	Havona et le Paradis
Growth in the Kingdom of Heaven	La Croissance dans le Royaume des Cieux
Study on Guardian Angels	Étude Sur Les Anges Gardiens
Report of the AFLLU Ordinary General Meeting	Compte Rendu De L'assemblée Générale Ordinaire AFLLU
Meeting in Italy Vth Congress	Rencontre En Italie Vème Congrès
Communication by Johana August 21, 2019	Communication De Johana 21 Août 2019
The Urantia Book Is a Bulky Book	Le Livre D'Urantia Est Un Livre Volumineux
Le Lien Urantien — Issue 88 — December 2019	Le Lien Urantien — Numéro 88 — Décembre 2019
Le Lien Urantien — Issue 88 — December 2019 — Contents	Le Lien Urantien — Numéro 88 — Décembre 2019 — Contenu
Editorial	Éditorial
On the First Moments of Survival	Sur Les Premiers Instants De La Survie
When Are We Granted Personality?	Quand La Personnalité Nous Est-Elle Octroyée?
When Are We Granted Personality?	Quand La Personnalité Nous Est-Elle Octroyée?
Some information about Urantia Foundation	Quelques informations sur la Fondation Urantia
Search, Discover, Understand	Chercher, Découvrir, Comprendre
2020	2020
Le Lien Urantien — Issue 89 — March 2020	Le Lien Urantien — Numéro 89 — Mars 2020
Le Lien Urantien — Issue 89 — March 2020 — Contents	Le Lien Urantien — Numéro 89 — Mars 2020 — Contenu
Editorial	Éditorial
Christianity As An Opportunity	Le Christianisme Comme Une Chance
Water: Truth, Beauty, And Goodness	L'eau : Vérité,Beauté Et Bonté
A Great Confusion About Race	Une Grande Confusion Sur La Race
National Meeting At Notre Dame Des Lumières	Réunion Nationale À Notre Dame Des Lumières
Le Lien Urantien — Issue 90 — June 2020	Le Lien Urantien — Numéro 90 — Juin 2020
Le Lien Urantien — Issue 90 — June 2020 — Contents	Le Lien Urantien — Numéro 90 — Juin 2020 — Contenu
Editorial	Éditorial
Human Personality	La Personnalité Humaine
Contact With The Thought Adjuster	Contact Avec L'Ajusteur de Pensée
For Jesus	Pour Jésus
In This Matter	Dans Cette Affaire
Essays On Defining Space	Essais De Définition De L'espace
Reflection On Thought	Réflection Sur La Pensée
Who Am I?	Qui Suis-Je?
Le Lien Urantien — Issue 91 — September 2020	Le Lien Urantien — Numéro 91 — Septembre 2020
Le Lien Urantien — Issue 91 — September 2020 — Contents	Le Lien Urantien — Numéro 91 — Septembre 2020 — Contenu
Editorial	Éditorial
“The Intergalactic Wanderer”	« Le Vagabond Intergalactique »
The Prophets	Les Prophètes
How Big Is Paradise?	Quelle Est La Dimension Du Paradis ?
Earthly Escape	Évasion Terrestre
The Soul Within	L'âme En Soi
Is There An Archetype, An Ideal Model For The Relationship Between Man And Woman?	Y a-t-il un Archétype, un Modèle Idéal pour la Relation Homme — Femme ?
Le Lien Urantien — Issue 92 — December 2020	Le Lien Urantien — Numéro 92 — Décembre 2020
Le Lien Urantien — Issue 92 — December 2020 — Contents	Le Lien Urantien — Numéro 92 — Décembre 2020 — Contenu
Editorial	Éditorial
Study Revelation For What?	Étudier La Révélation Pour Quoi Faire ?
Science And Revelations	Science Et Révélations
A Universe Without The Big Bang	Un Univers Sans Big-Bang
The Urantia Book In Esperanto	Le Livre D'urantia En Espéranto
Personality	La Personnalité
Can We Still Hunt The Dinosaur In Satania?	Peut-On Encore Chasser Le Dinosaure Dans Satania?
2021	2021
Le Lien Urantien — Issue 93 — March 2021	Le Lien Urantien — Numéro 93 — Mars 2021
Le Lien Urantien — Issue 93 — March 2021 — Contents	Le Lien Urantien — Numéro 93 — Mars 2021 — Contenu
Editorial	Éditorial
Prayer Was Not One	La Priêre N'en Était Pas Une
The Urantia Book And The Grand Conspiracy Theory?	Le Livre D'urantia Et La Théorie du Grand Complot ?
Foundation News	Nouvelles De La Fondation
The UBIS School Why Do It?	L'école UBIS Pour Quoi Faire?
A Fantastic Journey	Un Voyage Fantastique
From Energy To Matter	De L'énergie À La Matiêre
4000 Years Of Machiventa Melchizedek	4000 Ans De Machiventa Melchizédek
Jesus' Journeys Before His Public Ministry	Vovages De Jésus Avant Son Ministere Public
Jesus' Life Timeline	Chronologie De La Vie De Jésus
Jesus' Appearances	Les Apparitions De Jésus
The Train	Le Train
Le Lien Urantien — Issue 94 — June 2021	Le Lien Urantien — Numéro 94 — Juin 2021
Le Lien Urantien — Issue 94 — June 2021 — Contents	Le Lien Urantien — Numéro 94 — Juin 2021 — Contenu
Editorial	Éditorial
Introducing The Urantia Book	Présentation Du Livre D’Urantia
Perfume Of A Woman	Parfum De Femme
Experiencing Perfection	L'expérience De La Perfection
For Geneticists	Pour Les Généticiens
God, Time, And The Universe	Dieu, Le Temps Et L'univers
Le Lien Urantien — Issue 95 — September 2021	Le Lien Urantien — Numéro 95 — Septembre 2021
Le Lien Urantien — Issue 95 — September 2021 — Contents	Le Lien Urantien — Numéro 95 — Septembre 2021 — Contenu
Editorial	Éditorial
The Urantia Cosmogony	La Cosmogonie d'Urantia
Science Or Revelation	Science ou Révélation
Life In Spirit	La Vie En Esprit
What The Urantia Book Means To Me	Ce que Le Livre d'Urantia signifie pour Moi
God, Time, The Universe	Dieu, Le Temps, L'univers
Reprinting The Urantia Book	Réimpression Du Livre D’Urantia
Le Lien Urantien — Issue 96 — December 2021	Le Lien Urantien — Numéro 96 — Décembre 2021
Le Lien Urantien — Issue 96 — December 2021 — Contents	Le Lien Urantien — Numéro 96 — Décembre 2021 — Contenu
Editorial	Éditorial
MAX Is In Transit To Maisonia No. 1 From Jerusem	MAX est en transit vers Maisonia Nº1 De Jérusem
Progress Through Education	Le Progrès par l'Éducation
Promise Me	Promets-moi
A Global Vision	Une Vision Globale
Philosophical Pause	Pause Philosophique
Foundation News	Nouvelles de la Fondation
Vive La Différence	Vive La Différence
2022	2022
Le Lien Urantien — Issue 97 — March 2022	Le Lien Urantien — Numéro 97 — Mars 2022
Le Lien Urantien — Issue 97 — March 2022 — Contents	Le Lien Urantien — Numéro 97 — Mars 2022 — Contenu
Editorial	Éditorial
Time and Levels of Consciousness	Temps et Niveaux De Conscience
How to Do the Will of the Father	Comment Faire La Volonté Du Pére
The Seven Master Spirits	Les Sept Maitres Esprits
The History of Life	L'histoire De La Vie
Cell Division (Wikipedia)	La Division Cellulaire (Wikipedia)
EON (Wikipedia)	EON (Wikipedia)
The Earth	La Terre
Consciousness and Superconsciousness	Conscience Et Superconscience
Le Lien Urantien — Issue 98 — June 2022	Le Lien Urantien — Numéro 98 — Juin 2022
Le Lien Urantien — Issue 98 — June 2022 — Contents	Le Lien Urantien — Numéro 98 — Juin 2022 — Contenu
Editorial	Éditorial
A Spiritual Quest: God in Question	Une Quête Spirituelle: Dieu En Question
From Divine Incompleteness to Human Adventure	De L'incomplétude Divine À L'aventure Humaine
The Hazards of a Decimal Planet	Les Aléas D'une Planète Décimale
The Foundation Communicates: The Future of Urantia: Elements for Reflection	La Fondation Communique: L'avenir D'urantia: Éléments De RéFlexion
The Earth	La Terre
Le Lien Urantien — Issue 99 — September 2022	Le Lien Urantien — Numéro 99 — Septembre 2022
Le Lien Urantien — Issue 99 — September 2022 — Contents	Le Lien Urantien — Numéro 99 — Septembre 2022 — Contenu
Editorial	Éditorial
The Wisdom of Creating Unequal Races	La Sagesse De Créer Des Races Inégales
The Wisdom of Creating Unequal Races	La Sagesse De Créer Des Races Inégales
Why I Believe in God	Pourquoi Je Crois en Dieu
The Human Personality	La Personnalité Humaine
News from the Foundation	Nouvelles de la Fondation
3rd European Urantia Congress in Spain	3ème Congrès Européen D'urantia En Espagne
A Birthday	Un Anniversaire
Le Lien Urantien — Issue 100 — December 2022	Le Lien Urantien — Numéro 100 — Décembre 2022
Le Lien Urantien — Issue 100 — December 2022 — Contents	Le Lien Urantien — Numéro 100 — Décembre 2022 — Contenu
Editorial	Éditorial
AUGUST 21, 2022	21 AOUT 2022
Dare to God	Oser Dieu
News from the French-speaking Groups	Nouvelles des Groupes Francophones
Lumieres 2022	Lumières 2022
Relationships Between Material, Mental and Spirit	Relations Entre Matériel, Mental Et Esprit
Urantia Conference In Uganda 2022	Conférence Urantia En Ouganda 2022
General Assembly Report	Compte Rendu Assemblée Générale
2023	2023
Le Lien Urantien — Issue 101 — March 2023	Le Lien Urantien — Numéro 101 — Mars 2023
Le Lien Urantien — Issue 101 — March 2023 — Contents	Le Lien Urantien — Numéro 101 — Mars 2023 — Contenu
Editorial	Éditorial
Relationships between material, mental and spirit	Relations entre matériel, mental et esprit
At the Tomb	Au Tombeau
Revelation of the Middle Ages	Révélation du Moyen Âge
Our UBIS Experience	Notre expérience UBIS
Fantasy on a Major Theme	Fantaisie Sur Un Thème Majeur
Activities Dakar Group	Activités Groupe De Dakar
Ministry in the Philippines	Ministère Aux Philippines
UBIS School	École UBIS
Urantia Foundation News	Nouvelles De La Fondation Urantia
Le Lien Urantien — Issue 102 — June 2023	Le Lien Urantien — Numéro 102 — Juin 2023
Le Lien Urantien — Issue 102 — June 2023 — Contents	Le Lien Urantien — Numéro 102 — Juin 2023 — Contenu
Editorial	Éditorial
AFLLU Meeting	Réunion AFLLU
AFLLU Report	Compte Rendu AFLLU
Testimonials	Témoignages
Adjuster, Absoluteness and Fusion	Ajusteur, Absoluité et Fusion
The House	La Maison
Readers' Mail	Cœurrier des lecteurs
Le Lien Urantien — Issue 103 — September 2023	Le Lien Urantien — Numéro 103 — Septembre 2023
Le Lien Urantien — Issue 103 — September 2023 — Contents	Le Lien Urantien — Numéro 103 — Septembre 2023 — Contenu
Editorial	Éditorial
Life	La Vie
Fantasy on a Major Theme	Fantaisie Sur Un Thème Majeure
Feedback	Retour D'expérience
Some Comments on the Difficulties of Disseminating the 5th Revelation	Quelques Propos Sur Les Difficultés De Diffusion De La 5e Révélation
The Cat's Poem	Le Poême Du Chat
On the Necessary Fertilization of Our Thought	De La Nécessaire Fécondation De Notre Pensée
Dispensational Resurrections — Planetary Ages	Résurrections Dispensationnelles — Âges Planétaires
Le Lien Urantien — Issue 104 — December 2023	Le Lien Urantien — Numéro 104 — Décembre 2023
Le Lien Urantien — Issue 104 — December 2023 — Contents	Le Lien Urantien — Numéro 104 — Décembre 2023 — Contenu
Editorial	Éditorial
Will We Be Eternally Subject to Material Gravity?	Serons-nous éternellement soumis à la gravité matérielle?
At the Theater of Time	Au théâtre du temps
The Flask	Le Flacon
Will, Personality, Moral Choice	Volonté, personnalité, choix moral
History of the Journal Reflectivity	Historique du journal Réflectivité
Cosmic Consciousness and Spiritual Perception	Conscience Cosmique et Perception Spirituelle
Readers' Mail	Cœurrier des lecteurs
2024	2024
Le Lien Urantien — Issue 105 — March 2024	Le Lien Urantien — Numéro 105 — Mars 2024
Le Lien Urantien — Issue 105 — March 2024 — Contents	Le Lien Urantien — Numéro 105 — Mars 2024 — Contenu
Editorial	Éditorial
Abortion	Avortement
Urantia Foundation News	Nouvelles de la Fondation Urantia
Philosophical and Historical Approach to Quantum Mechanics	Approche philosophique et historique de la mécanique quantique
The Chinese Translation of The Urantia Book	La traduction chinoise de The Urantia Book
Differences Between Simplified and Traditional Chinese Characters	Différences entre les caractères chinois Simplifiés et Traditionnels
Le Lien Urantien — Issue 106 — June 2024	Le Lien Urantien — Numéro 106 — Juin 2024
Le Lien Urantien — Issue 106 — June 2024 — Contents	Le Lien Urantien — Numéro 106 — Juin 2024 — Contenu
Editorial	Éditorial
Part Two: The Revelation	Deuxième Partie: La Révélation
Tale of the Three Thinkers	Conte des trois penseurs
Will We Survive?	Survivrons-nous?
Repersonalization	Repersonnalisation
Discovering Paradise and Space-Time	À la découverte du Paradis et de l'Espace-Temps
AFLLU Conference 2025 In Paris (France) AFLLU	Conférence AFLLU 2025 À Paris (France) AFLLU
Le Lien Urantien — Issue 107 — September 2024	Le Lien Urantien — Numéro 107 — Septembre 2024
Le Lien Urantien — Issue 107 — September 2024 — Contents	Le Lien Urantien — Numéro 107 — Septembre 2024 — Contenu
Editorial	Éditorial
The Woman	La Femme
What is Behind the "I AM"?	Derrière le «JE SUIS» qu'est-CeQu'ily a ?
Lost Tradition	Tradition perdue
I AM and the Principle of Causality	JE SUIS et le Principe de causalité
The Little Seed	La petite graine
European Meeting 2025	Réunion Européenne 2025
AFLLU Meeting — Neylieres 2024	Réunion AFLLU — Neylieres 2024
Report of the National Meeting of the A.F.L.L.U	Raport de la réunion nationnale de L'A.F.L.L.U