Index of Urantia Foundation's News Online articles	Index des articles des Nouvelles en ligne de la Fondation Urantia
Volume 1, 2007	Volume 1, 2007
Volume 1, Issue 1, May 2007	Volume 1, numéro 1, mai 2007
Welcome & Contact Details	Bienvenue et coordonnées
Welcome	Accueillir
Newsworthy Items From The April 2007 Trustees Meeting	Réunion du conseil d'administration
The Urantia Book In India	L'LU en Inde
Urantia Foundation Staff: Jay Peregrine	Jay Pérégrin
Volume 1, Issue 2, Sept. 2007	Volume 1, numéro 2, septembre 2007
Welcome & Contact Details	Bienvenue et coordonnées
Even as I have loved you	Même si je t'ai aimé
Newsworthy Items From The August, 2007 Trustee Meeting	Réunion du conseil d'administration août 2007
Foundation Prints A Portuguese Translation	Traduction portugaise
An Educational Initiative	Une initiative pédagogique
Distribution: El Libro De Urantia	Distribution : Le Livre d'Urantia
A Short History Of The Owners Of Urantia Foundation's Head Office	Historique du siège social
Comments On Urantia Online	Commentaires
Trustee Emerita Patricia Mundelius Leaves Expanded Board	Feuilles de Patricia Mundelius
Reflections	Réflexions
Help Wanted	Aide recherchée
Volume 1, Issue 3, Dec. 2007	Volume 1, numéro 3, décembre 2007
Welcome & Contact Details	Bienvenue et coordonnées
Tension — the Prerequisite of Growth	La tension – la condition préalable à la croissance
Urantia Foundation Launches Matching Fundraising Campaign In December, 2007	Campagne de collecte de fonds de contrepartie
Newsworthy Decisions From Urantia Foundation's October Trustees Meeting	Décisions: réunion du conseil d'administration d'octobre
German Translation Brings Readers Together	La traduction allemande rassemble les lecteurs
Neal Waldrop Concludes Four Years of Active Participation	Neal Waldrop conclut quatre années de participation active
Millennial Reflections	Réflexions millénaires
Seeding the Revelation in South Africa	Semer la révélation en Afrique du Sud
Volume 2, 2008	Volume 2, 2008
Volume 2, Issue 1, March 2008	Volume 2, numéro 1, mars 2008
Welcome & Contact Details	Bienvenue et coordonnées
The Secret of a Better Civilisation	Le Secret d’une Civilisation Meilleure
O Livro de Urântia Premiered in Brazil	O Livro de Urântia, en Première au Brésil
Newsworthy Decisions From Urantia Foundation's January 2008 Trustees Meeting	Points d’Intérêts des Décisions de la Fondation Urantia à la réunion des Trustees de janvier 2008
Japanese Translation Continues To Progress	La Traduction japonaise continue de progresser
In Memorium: Karlheinz Stockhausen	Le Célèbre Compositeur ( et Lecteur du Livre d’Urantia ) Karlheinz Stockhausen est décédé
Study Groups: The Principle Of Sharing	Les groupes d’étude : le Principe du Partage
Reflections on introducing The Urantia Book	Pensées sur le sujet de Présenter Le Livre d’Urantia
Testimonials About The Urantia Book	Témoignages à propos du Livre d’Urantia
Two new Trustees elected	Deux nouveaux administrateurs élus
Volume 2, Issue 2, June 2008	Volume 2, numéro 2, juin 2008
Welcome & Contact Details	Bienvenue et coordonnées
The Revelation Enters the 21st Century	La Révélation entre dans le 21ième siècle
Noteworthy Decisions From The April 2008 Board Meeting In Paris	Décisions d'intérêts de la Réunion du conseil d'administration d'avril 2008 à Paris
Buenos Aires Book Fair	La foire du livre à Buenos Aires
The Urantia Community Endowment: A Fund For The Future	La Dotation De Communauté Urantia : Un Fond Pour Le Futur
Duane Faw: Honoring a Man Who Served the Revelation	Duane Faw – honneur à un homme qui servit la révélation
Volume 2, Issue 3, Sept. 2008	Volume 2, numéro 3, septembre 2008
Welcome & Contact Details	Bienvenue et coordonnées
Seppo Kanerva announces his Retirement	Seppo Kanerva annonce son départ à la retraite
The Future of the Urantia Movement	L’avenir du Mouvement Urantien
Newsworthy Decisions Made By Urantia Foundation's Board Of Trustees	Points D’intérêts Des Décisions Prises Par Le Conseil d’Administration De La Fondation Urantia
Printing Of El Libro De Urantia European Edition	L’Impression de El libro de Urantia édition Européenne
A Tribute to Pat Mundelius	Un Hommage à Pat Mundelius
Why Is The Urantia Book Religious But Not a Religion?	Le Livre d’Urantia Est-Il Une Religion?
Are You a New Religion or a Cult?	Etes-vous une nouvelle religion ou un culte ?
UBIS... Celebrating 10 Years of Dedicated Service To The Urantia Book Community	UBIS … Célébration De 10 Ans De Travail Dédié Au Service De La Communauté Du Livre d’Urantia
Volume 2, Issue 4, Dec. 2008	Volume 2, Numéro 4, décembre 2008
Welcome & Contact Details	Bienvenue et coordonnées
Holiday Greetings From Urantia Foundation	Vœux de la Fondation Urantia
Urantia Foundation Launches Matching Fund-Raising Campaign 2008	La Fondation Urantia Lance la Campagne de Collecte de Fonds à égalisation de 2008
Noteworthy Decisions From The November 2008 Board Meeting	Points d’Intérêts des Décisions de la Réunion du Conseil d’Administration de Novembre 2008
The Urantia Book In Austria	Le Livre d’Urantia en Autriche
Education And Urantia Foundation	l’Education et la Fondation Urantia
Second Meeting of Urantia Book Readers In Germany	Deuxième Rencontre des Lecteurs du Livre d’Urantia en Allemagne
Henk Mylanus, New Associate Trustee And European Manager Of Sales	Henk Mylanus , Nouveau Trustee Associé et Directeur Européen des Ventes
Reflections	Pensées
Volume 3, 2009	Volume 3, 2009
Volume 3, Issue 1, March 2009	Volume 3, Numéro 1, Mars 2009
Welcome & Contact Details	Bienvenue et coordonnées
Kind and Generous Souls	Bonnes et Généreuses Ames
Noteworthy Decisions From The January 2009 Board Meeting	Points D’intérêt Des Décisions De La Réunion Du Conseil D’administration De Janvier 2009
A Vision of the Future	Une Vision du Futur
The History of the Polish Translation	L’histoire De La Traduction Polonaise
Standard Reference Text Commiffee Report	Rapport Du Comité Du Texte Standard De Référence
Millennial Reflections	Pensées du Millenium
The Urantia Book Index Project	Le Projet De L’index De The Urantia Book
UBIS is Hot!	UBIS est en VOGUE !
Holiday Party At 533 Diversersey	Féte de Noël à Diversey 533
Volume 3, Issue 2, June 2009	Volume 3, numéro 2, juin 2009
Welcome & Contact Details	Bienvenue et coordonnées
Gratitude To Those Who Serve The Revelation	Gratitude Envers Ceux Qui Servent La Révélation
Pre-Conference Leadership Roundtable	Pré-Conférence De Table Ronde Des Leaders
Noteworthy Decisions From The April 2009 Board Meeting	Points D’intérêts Des Décisions De La Réunion Du Conseil d’Administration D’avril 2009
God Consciousness — A Living University	La Conscience De Dieu – Une Université Vivante
Update From The Urantia Book Internet School (UBIS)	Informations de l’École Internet du Livre d’Urantia (UBIS)
Looking For A French Distributor	Recherche d’un Distributeur Français
The Urantia Book And Christianity	Le Livre d’Urantia et le Christianisme
Printing of El Libro De Urantia European Edition	L’impression Du El libro de Urantia, L’édition Européenne
The Second Mile As A Community Experience	La Seconde Lieue En Tant Qu’expérience Communautaire
Reflections — Where Gaps Were Bridged	Pensées – Quand Les Ponts Furent Jetés
Volume 3, Issue 3, Sept. 2009	Volume 3, numéro 3, septembre 2009
Welcome & Contact Details	Bienvenue et coordonnées
The Road Ahead	Le Chemin à Venir
Parliament of the World's Religions 2009	Le Parlement des Religions du Monde
Noteworthy Decisions from the July 2009 Board Meeting	Décisions du Conseil d’Administration à la Réunion de Juillet 2009
The History of the Hungarian (Magyar) Translation	L’histoire De La Traduction Hongroise ( Magyar )
Interest in the Chinese Translation	Intérêt Pour La Traduction Chinoise
The Second Mile In Retrospect: Thoughts On The Boulder Experiment	La Seconde Lieue En Rétrospective : Pensées Sur L’éxpérience De Boulder
Reflections on 533 Diversey	Pensées sur Diversey 533
El Libro De Urantia — European Edition	El libro de Urantia – l’édition Européenne
Quebec Office Closed	Fermeture du Bureau du Québec
God Consciousness: A Living University Inspires In-Depth Study	La conscience de Dieu : une université vivante inspire l’étude en profondeur
A Poem for Bert Cobb	Un Poème pour Bert Cobb
Volume 3, Issue 4, Dec. 2009	Volume 3, Numéro 4, décembre 2009
Welcome & Contact Details	Bienvenue et coordonnées
Urantia Foundation Launches Matching Fund-Raising Campaign 2009	La Fondation Urantia Lance la Campagne de Collecte de Fonds à Egalisation de 2009
Jesus and Ganid	Jésus et Ganid
Noteworthy Decisions From The October 2009 Board Meeting	Points D’intérêt Des Décisions Du Conseil d’Administration D’octobre 2009
Library Placement	Placement Dans les Bibliothèques
When Great Britain Meets Little Brittany	Quand la Grande Bretagne Rencontre la Petite Bretagne
The Pipeline of Light	Le Pipeline de Lumière
The French Audio Version of Le Livre d'Urantia	La Version Audio Du Livre d’Urantia En Français
Das Urantia Buch in Munich	_Das Urantia Buch_ à Munich
Meeting of the IT Minds	Réunion des Cerveaux IT
Volume 4, 2010	Volume 4, 2010
Volume 4, Issue 1, March 2010	Volume 4, numéro 1, mars 2010
Welcome & Contact Details	Bienvenue et coordonnées
Reflections on 2009 and a Look into the Future	Réflexions Sur 2009 Et Un Regard Dans Le Futur
Sweden and The Urantia Book	La Suède et Le Livre d’Urantia
Parliament of The World's Religions	Le Parlement des Religions du Monde
Unexpected Joy	Une Joie Inattendue
A Gathering In Mexico City	Une réunion à Mexico
Our Trip To Mexico City	Notre Voyage à Mexico
Orlando Florida: Another Chapter Unfolds	Orlando, en Floride : Un Utre Chapitre Se Dévoile
Volume 4, Issue 2, June 2010	Volume 4, numéro 2, juin 2010
Welcome & Contact Details	Bienvenue et coordonnées
1,000 Libraries, 1,000 Book Reviews, and 1,000 Study Groups	1000 Librairies, 1000 Avis De Lecteurs Et 1000 Groupes D'étude
Noteworthy Decisions from the April 2010 Board Meeting	Points D'intérêt Des Décisions De La Réunion Du Conseil d'Administration D'avril 2010
UBIS News: A New Website, an Expanded Curriculum, and the Challenge Ahead	Nouvelles D'ubis : Un Nouveau Site Web, Un Programme Élargi Et Le Challenge Qui Nous Attend
Introducing the Urantia Book Historical Society	Présentation de la Société Historique du Livre d'Urantia
Attending the Book Fair in Budapest, Hungary	La Foire Du Livre De Budapest, Hongrie
9th National Meeting Of Readers In Spain — Cultivating Universal Intelligence	9ième Réunion Nationale Des Lecteurs d'Espagne - Cultiver L'intelligence Universelle
Nola Smith: A Pioneer in Launching the Urantia Revelation	Nola Smith : une pionnière qui lança la révélation d'Urantia
Volume 4, Issue 3, Sept. 2010	Volume 4, numéro 3, septembre 2010
Welcome & Contact Details	Bienvenue et coordonnées
President's Report	Le Rapport Du Président
Noteworthy Decisions from the July 2010 Board Meeting	Décisions Importantes De La Réunion Du Conseil d'Administration De Juillet 2010
Dorothy Elder Passes the UBIS Leadership Torch	Dorothy Elder Passe La Flambeau De La Direction d'UBIS
Appreciative Inquiry for Study Groups	« Appreciative Inquiry » Pour Les Groupes D’étude
Study Groups: New Thoughts from an Old Reader	Groupes d’étude : Nouvelles Pensées d’un Ancien Lecteur
A Follow Up to Placing Urantia Books in Alternative Libraries	Suite Sur Le Placement De Livres d’Urantia En Bibliothèques Alternatives
Comments from Readers of The Urantia Book	Commentaires de lecteurs du _Livre d'Urantia_
Volume 4, Issue 4, Dec. 2010	Volume 4, Numéro 4, décembre 2010
Welcome & Contact Details	Bienvenue et coordonnées
The Art of Translations	L’Art de la Traduction
Receiving Az Urantia könyv, the Magyar (Hungarian) Translation of The Urantia Book	La Réception de Az Urantia Kőnyv , la Traduction Magyar (Hongroise) du Livre d’Urantia
El Libro De Urantia Edición Europea — The Spanish European Edition	El Libro De Urantia Edición Europea - l’Édition Espagnole Européenne
Urantiaboken — the Swedish Translation	Urantiaboken – la Traduction Suédoise
O Livro de Urântia — the Portuguese Translation	O Livro de Urântia – la Traduction Portuguaise
Księga Urantii: The Polish Translation Has Reached the Readers	Księga Urantii – La Traduction Polonaise Est Parvenue Aux Lecteurs
Das Urantia Buch — the German Translation	Das Urantia Buch – la Traduction Allemande
The Story Of Urantia Raamat — The Estonian Translation	L’Histoire d’Urantia Raamat – la Traduction Estonienne
Книга Урантии — the Russian Translation	Книга Урантии – la Traduction Russe
“Go Into All the World” — Jesus	«Allez Dans Le Monde Entier» - Jésus
Volume 5, 2011	Volume 5, 2011
Volume 5, Issue 1, March 2011	Volume 5, Numéro 1, mars 2011
Welcome & Contact Details	Bienvenue et coordonnées
The Age of Wonder	L’Âge des Merveilles
Noteworthy Decisions from the January 2011 Board of Trustees Meeting	Décisions Importantes De La Réunion Du Conseil d’Administration Des Trustees De Janvier 2011
The Education Initiative	L’Initiative d’Éducation
A Short History of the French Translation	Un Court Historique De La Traduction Française
Second Society Foundation and A Study of the Master Universe	La Fondation de la Seconde Société et Une Étude du Maître Univers
The Trustees Meet in the Lone Star State	Les Trustees se Réunissent Dans l’Etat de l’Étoile Solitaire
Comments from Readers of The Urantia Book	Commentaires des lecteurs du Livre d'Urantia
Volume 5, Issue 2, June 2011	Volume 5, numéro 2, juin 2011
Welcome & Contact Details	Bienvenue et coordonnées
Why Study Groups Matter to the Future of the World	Pourquoi Les Groupes D’étude Sont-Ils Importants Pour Le Futur Du Monde
Noteworthy Goals from the April 2011 Board of Trustees Meeting	Objectifs À Retenir De La Réunion Du Conseil d’Administration Des Trustees D’avril 2011
Jay Peregrine visits Finland	Jay Peregrine Visite la Finlande
The Spanish Revision Project	Le Projet De La Révision Espagnole
The Urantia Book Internet School — My Lifeline to the Urantia Book Community	L’école Internet Du Livre d’Urantia – Mon Lien Avec La Communauté Du Livre d’Urantia
The Debut of The Urantia Book at the 2011 Budapest Book Fair	Les Débuts Du Livre d’Urantia À La Foire Du Livre De 2011 À Budapest
Comments from Readers of The Urantia Book	Commentaires des lecteurs du Livre d'Urantia
Volume 5, Issue 3, Sept. 2011	Volume 5, Numéro 3, septembre 2011
Welcome & Contact Details	Bienvenue et coordonnées
Report on the Kickoff Meeting for the Revision of the Spanish Translation	Compte rendu de la réunion pour le coup d’envoi de la révision de la traduction eespagnole
Noteworthy Goals and Decisions from the July 2011 Board of Trustees Meeting	Objectifs et décisions importantes de la réunion du Conseil d’administration des Trustees de juillet 2011
Urantia Book Readers Study Together this Summer	Les lecteurs du Livre d’Urantia étudièrent ensemble cet été
Training Teachers/Facilitators for the Urantia Book Internet School	Former des enseignants/animateurs pour l’École Internet d’Urantia
Planned Giving to Urantia Foundation	Faire un don planifié à la Fondation Urantia
Report from the Pipeline of Light 2003-2011	Compte rendu sur le Pipeline de Lumière 2003-2011
A Reader's Experience Staying at 533 W Diversey Parkway	L’expérience d’un lecteur séjournant à 533 Diversey Parkway
Comments from Readers	Commentaires des lecteurs
Volume 5, Issue 4, Dec. 2011	Volume 5, numéro 4, décembre 2011
Welcome & Contact Details	Bienvenue et coordonnées
A Season of Gratitude and a Time for Generosity	Une période de gratitude et un temps pour la générosité
Noteworthy Decisions from the October 2011 Board of Trustees Meeting	Décisions importantes de la réunion du Conseil d’Administration des Trustees d’octobre 2011
Fast Start for Urantia Book Study Group Portal — Tri-Partisan Support Team Formed	Départ fulgurant du portail des groupes d’étude du Livre d’Urantia
The Rewards of Being a Teacher/Facilitator for UBIS	Être un enseignant/animateur d’UBIS est gratifiant
Report on the Kickooff Meeting for the Revision of the Portuguese Translation	Rapport sur la réunion du coup d’envoi de la révision de la traduction portugaise
Das Urantia Buch Presented at the Book Fair in Rasatt, Germany	Das Urantia Buch présenté à la Foire du Livre à Rasatt, en AlLemagne
The Siegels Visit Sweden, Estonia, Russia, and Finland in June, 2011	Les Siegel visitent la Suède, l’Estonie, la Russie et la Finlande, en juin 2011
Centering Prayer Retreat in Brittany, France	Séminaire sur la prière de consentement en Bretagne, France
A New Associate Trustee Is Appointed	Nomination d’un nouveau Trustee Associé - Jay Bird
Comments from Readers	Commentaires des lecteurs
Volume 6, 2012	Volume 6, 2012
Volume 6, Issue 1, March 2012	Volume 6, numéro 1, mars 2012
Welcome & Contact Details	Bienvenue et coordonnées
Our Journey to South America	Notre voyage en Amérique du Sud
Noteworthy Decisions from the January 2012 Board of Trustees Meeting	Décisions importantes de la rúnion du Conseil d’administration de janvier 2012
Teacher-Facilifators Needed for the Urantia Book Internet School	Nous avons besoin d’enseignants–animateurs pour l’École Internet du Livre d’Urantia
The Urantia Book around the world	Le Livre d’Urantia à travers le monde
Comments from Readers of The Urantia Book	Commentaires des lecteurs du Livre d'Urantia
Volume 6, Issue 2, June 2012	Volume 6, numéro 2, juin 2012
Welcome & Contact Details	Bienvenue et coordonnées
Worship and Wisdom at 533 W Diversey Parkway	Adoration et sagesse à 533, Diversey Parkway
Noteworthy Decisions from the April 2012 Board of Trustees Meeting	Importantes Décisions De La Réunion Du Conseil d'administration des Trustees, d’Avril 2012
The Hebrew Translation of The Urantia Book	La traduction hébraïque du Livre d’Urantia
Reflections on the 11th meeting of Urantia Book readers in Spain	Réflexions sur la 11ème réunion des lecteurs du Livre d’Urantia en Espagne
A Meredith Sprunger Story	Une histoire à propos de Meredith Sprunger
How I found The Urantia Book	Comment j'ai trouvé le Livre d'Urantia
Help Wanted for Translations	Aide demandée pour les traductions
My trip to Colombia, South America	Mon voyage en Colombie, Amérique du Sud
Urantia Book Study Group Directory	L’Annuaire des groupes d’étude du Livre d’Urantia
Two New Appointments	Deux nouvelles nominations - Line St-Pierre, Share Beasley
Reader Comments	Commentaires De Lecteurs
Irmeli Ivalo-Sjölie: Book Ambassador at Large	Irmeli Ivalo-Sjölie : ambassadrice du livre en action
Volume 6, Issue 3, Aug. 2012	Volume 6, Numéro 3, Août 2012
Welcome & Contact Details	Bienvenue et coordonnées
Pulling Together for the Common Good	Ramer à l’unisson dans l’intérêt de tous
Noteworthy Decisions from the July 2012 Board of Trustees Meeting	Décisions importantes de la réunion du Conseil d’administration des trustees de juillet 2012
The Urantia Book and its teachings in Babasa Indonesia	Le Livre d’Urantia et ses enseignements en indonésien bahasa
Spanish UBIS—One More Step in the Expansion of the Urantia Book Internet School	UBIS en espagnol — un pas de plus dans l’expansion de l’Ècole Internet du Livre d’Urantia
The Evolution of Translations	Évolution des traductions
A Timeline for The Urantia Book	Une chronologie du Livre d’Urantia et de ses traductions
Five Days at 533 W Diversey Parkway	Cinq jours à 533, Diversey Parkway
A Summer Urantia Book Conference in Berlin	Une conférence d’été du Livre d’Urantia à Berlin
Remembering Mary Lou Hales	À la mémoire de Mary Lou Hales
Remembering Werner Sutter	À la mémoire de Werner Sutter
Volunteers Needed	Volontaires demandés - l’Index du Livre d’Urantia
Comments from readers	Commentaires De Lecteurs
Volume 6, Issue 4, Nov. 2012	Volume 6, numéro 4, novembre 2012
Welcome & Contact Details	Bienvenue et coordonnées Réunion
Joint Meeting of The Urantia Book Fellowship and Urantia Foundation	Réunion commune entre la Fellowship du Livre d’Urantia et la Fondation Urantia
Winter Fundraising Match of $160,000 Launches Now	La campagne de collecte de fonds à égalisation de 160 000 $ commence maintenant
An Audio Version of The Urantia Book in Portuguese	Une version audio du Livre d’Urantia en portugais
Engineering the Audio _O Livro de Urântia_	Production audio de O Livro de Urântia
Noteworthy Decisions from the October 2012 Board of Trustees Meeting	Décisions marquantes de la réunion d’octobre 2012 du Conseil d’administration
A Community Introduction to The Urantia Book	Une introduction collective au Livre d’Urantia
A Seminar on the Truths of Spiritual Experience	Un séminaire sur les vérités de l’expérience spirituelle
The Number of Urantia Books Printed between 1955 and 2012	Nombre de Livres d’Urantia imprimés entre 1955 et 2012
The Third Urantia Book Information Technology (IT) Roundtable	La troisiéme Table ronde (IT) d’information technologique du Livre d’Urantia
Impressions of the Information Technology Roundtable	Impressions sur la table ronde d’information technologique
Reader Comments	Commentaires De Lecteurs
Urantia Book Holiday Sale	Vente de vacances du Livre d'Urantia
Volume 7, 2013	Volume 7, 2013
Volume 7, Issue 1, March 2013	Volume 7, numéro 1, mars 2013
Welcome & Contact Details	Bienvenue et coordonnées
Urantia Foundation Announces New Book Covers For The Urantia Book	La Fondation Urantia présente les nouvelles couvertures du Livre d’Urantia
Noteworthy Decisions from the January 2013 Board of Trustees Meeting	Décisions marquantes de la réunion du Conseil d’administration des Trustees de janvier 2013
The 2012 Survey of Readers of The Urantia Book	L’enquête de 2012 sur les lecteurs du Livre d’Urantia
Finding a Distributor in Hungary for the Hungarian translation, Az Urantia könyv	La recherche d’un distributeur en Hongrie pour la traduction hongroise Az Urantia könyv
Around the World with Urantia Book. Ambassador Irmeli Ivalo-Sjölie	À travers le monde avec l’ambassadrice du Livre d’Urantia, Irmeli Ivalo-Sjölie
How the Idea for a Urantia Book Translation Tool was Born	Comment l’idée d’un outil de traduction pour le Livre d’Urantia vit le jour
A Group Meditation at Urantia Foundation	Un groupe de méditation à la Fondation Urantia
Half Price Books-an Opportunity for Urantia Book Dissemination	« Half Price Books », une opportunité pour la dissémination du Livre d’Urantia
A Thank You Note from Chile	Un mot de remerciement du Chili
A Reader's Comment	Le commentaire d'un lecteur
Announcements	Annonces
Volume 7, Issue 2, June 2013	Volume 7, numéro 2, juin 2013
Welcome & Contact Details	Bienvenue et coordonnées
New Planned Giving Website at Urantia.org	Nouveau site web pour les dons planifiés, sur Urantia.org
Notewortby Decisions from the April 2013 Board of Trustees Meeting	Décisions importantes de la réunion d’avril 2013 du Conseil d’Administration des Trustees
A Decimal Seminar	Un séminaire décimal
The Urantia Book in Spain	Le Livre d’Urantia en Espagne
Translating The Urantia Book Into Farsi: The Inspiring Story Of How This Project Began	Traduction du Livre d’Urantia en farsi : L’histoire inspirante de la façon dont ce projet débuta
Inspire and Be Inspired	Inspirer et être inspiré
The Third Meeting of the Blue Club in Frankfurt, Germany	La troisième réunion du Blue Club à Frankfort, Allemagne
A New Platform for The Urantia Book Internet School	Une nouvelle plate-forme pour l’École Internet du Livre d’Urantia
A Reader's Comment	Le commentaire d'un lecteur
Volume 7, Issue 3, Sept. 2013	Volume 7, numéro 3, septembre 2013
Welcome & Contact Details	Bienvenue et coordonnées
Smart Religion	La religion intelligente
Noteworthy Decisions from the July 2013 Board of Trustees Meeting	Décisions importantes de la réunion du Conseil d’administration des trustees de juillet 2013
What the Women are Planning	Ce que les femmes planifient
The Urantia Book Study Group Directory	Le répertoire des groupes d’étude du Livre d’Urantia
One Student's Perspective on UBIS	Le point de vue d’un étudiant sur UBIS
A Tale of Two Conferences	Le récit de deux conférences
Urantia Book. Ambassador Irmeli Ivalo-Sjölie visits Finland, and the USA	L’ambassadrice du Livre d’Urantia, Irmeli Ivalo-Sjölie, visite la Finlande et les États-Unis
The Urantia Book in Korea	Le Livre d’Urantia en Corée
A Reader's Comment	Le commentaire d'un lecteur
Help Wanted	Aide demandée
Volume 7, Issue 4, Dec. 2013	Volume 7, Numéro 4, décembre 2013
Welcome & Contact Details	Bienvenue et coordonnées 
Matthew the Money-getter	Matthieu, le collecteur d’argent
Noteworthy Decisions from the October 2013 Board of Trustees Meeting	Décisions importantes de la réunion d’octobre 2013 du Conseil d’administration des trustees
Urantia Books En Route to the Philippines	Des Livres d’Urantia en route vers les Philippines
A Filmmaker's Approach to Promoting The Urantia Book	La Proposition d'un Cinéaste pour promouvoir Le Livre D'urantia
The Urantia Book Study Group Directory	Le répertoire des groupes d’étude du Livre d’Urantia
Holiday Party at Urantia Foundation	La fête de fin d’année à la Fondation Urantia
Adventures in Placing The Urantia Book	Mes aventures pour placer Le Livre d’Urantia
Growing Old Gracefully	Vieillir avec grâce
Job Opening At Urantia Foundation	Poste à Pourvoir à la Fondation Urantia
A Reader's Comment	Le commentaire d'un lecteur
Volume 8, 2014	Volume 8, 2014
Volume 8, Issue 1, March 2014	Volume 8, numéro 1, mars 2014
Welcome & Contact Details	Bienvenue et coordonnées
A Survey of Translators and Revisers of The Urantia Book	Une enquête sur les traducteurs et réviseurs du Livre d’Urantia
Noteworthy Decisions from the January 2014 Board of Trustees Meeting	Décisions importantes de la réunion du Conseil d’Administration des Trustees , de janvier 2014
The Urantia Book in the Philippines: an Outreach Project Update	_Le Livre d'Urantia_ aux Philipinnes : Une mise à jour d’un projet de sensibilisation
Restoring the Birthplace of the Fifth Epochal Revelation	Rénovation de la maison natale de la Cinquième Révélation d’Époque
Churchification	Devenir une église
The Study Group Symposium	Le Symposium des Groupes d’Étude
Preparing For My First International Conference	Préparation de ma première conférence internationale
What the Women Are Planning: a Report from our Second Gathering	Ce que les femmes planifient : un compte-rendu de notre deuxième réunion
A Reader's Comment	Comment le Livre d’Urantia m’a Trouvé et Ce Que Cela Signifie
Volume 8, Issue 2, July 2014	Volume 8, numéro 2, juillet 2014
Welcome & Contact Details	Bienvenue et coordonnées
Behind the Scenes of the Hebrew Translation Project	Dans les coulisses du projet de la traduction hébraïque
Noteworthy Decisions from the April 2014 Board of Trustees Meeting	Décisions importantes de la réunion du Conseil d’administration des trustees d’avril 2014
The Urantia Book: A Blessing for Ukraine	Le Livre d’urantia : une bénédiction pour l’Ukraine
The International Book Fair in Bogotá, Colombia	La foire internationale du livre de Bogota, Colombie
Second In-depth Revision of the French Translation	La seconde révision en profondeur de la traduction française
The Urantia Book Study Group Directory	Le répertoire des groupes d’étude du Livre d’Urantia
Journal of a Journey: Seeding Urantia Books in the Caribbean	Le journal d’un voyage : Semer des Livres d’Urantia dans les Caraïbes
The Urantia Book in the Philippines	Le Livre d’Urantia aux Philippines
A Workshop on the Soul	Un atelier sur l’âme
Trip to the Holy Land	Voyage en Terre Sainte
Volume 8, Issue 3, Sept. 2014	Volume 8, numéro 3, septembre 2014
Welcome & Contact Details	Bienvenue et coordonnées Ce
Happenings in Indonesia	Développements en Indonésie
Noteworthy Decisions from the July 2014 Board of Trustees Meeting	Décisions importantes de la réunion du Comité d’Administration des Trustees de juillet 2014
The Urantia Book in Guatemala	Le Livre d’Urantia au Guatemala
Joint Seminar of the Education Committees of Three Major Urantia Organizations	Séminaire commun des Comités d’Éducation des trois grandes organisations Urantia
International Conference 2014: A Personal Experience	Conférence internationale de 2014 : une expérience personnelle
A Dream Come True: Experiencing Urantia Foundation and the Study Group Symposium	Un rêve qui devient réalité : Faire l’expérience de la Fondation Urantia et du Symposium des Groupes d’Étude
The Study Group Symposium: Report on the Speeches	Le Symposium des Groupes d’Étude : Un compte-rendu des discours
The Beauty of Sharing: Seeding the teachings in Indonesia	La Beauté de Partager : Semer les enseignements en Indonésie
Finding The Urantia Book in Nigeria: an Answer to my Childhood Prayer	Trouver le Livre d’Urantia au Nigeria : une réponse à ma prière d’enfance
Announcements	Annonces
Volume 8, Issue 4, Dec. 2014	Volume 8, Numéro 4, décembre 2014
Welcome & Contact Details	Bienvenue et coordonnées
Urantia Foundation's Year-End Fundraising Match	Collecte de fonds à égalisation de fin d’année de la Fondation Urantia
Noteworthy Decisions from the October 2014 Board of Trustees Meeting	Décisions importantes de la réunion du Conseil d’Administration des Trustees d’octobre 2014
Urantia, Nebadon, and the Master Universe: A New Film on Perspectipe	Urantia, Nébadon, et le Maître Univers : un nouveau film en perspective
An Update from the Education Committee	Une mise à jour par le Comité d’Éducation
A Beach Retreat: What Prayer Was to Jesus	Une retraite à la plage : ce que la prière représentait pour Jésus
Reflections from The Women's Retreat	Réflexions sur la Retraite pour les Femmes
Comments from the Soul Workshop	Commentaires concernant l’Atelier sur l’Âme
What The Urantia Book Means to Me	Ce que le Livre d’Urantia signifie pour moi
Urantia Book Holiday Sale	Urantia Book Holiday Sale
Volume 9, 2015	Volume 9, 2015
Volume 9, Issue 1, March 2015	Volume 9, Numéro 1, mars 2015
Welcome & Contact Details	Bienvenue et coordonnées
A Urantia Book Booth at the Parliament of the Worlds Religions	Un stand du Livre d’Urantia au Parlement des religions du monde
Foundation Highlights of 2014	Points marquants de 2014
Noteworthy Decisions from the January 2015 Board of Trustees Meeting	Importantes décisions de la réunion du Conseil d’administration des trustees, de janvier 2015
The 2015 Intemational Book Fair in Jerusalem	La foire internationale du livre de 2015 à Jérusalem
Disseminating The Urantia Book in Ukraine	Propagation du Livre d’Urantia en Ukraine
What The Urantia Book Means to Me?	Qu’est-ce que Le Livre d’Urantia signifie pour moi ?
Urantia Book Outreach in the Philippines	Sensibilisation au Livre d’Urantia aux Philippines
How Discovering The Urantia Book Has Affected My Life	Comment la découverte du Livre d’Urantia a changé ma vie
Announcements	Annonces
Volume 9, Issue 2, June 2015	Volume 9, numéro 2, juin 2015
Welcome & Contact Details	Bienvenue et coordonnées
The Italian Translation of The Urantia Book	La traduction italienne du Livre d’Urantia
Noteworthy Decisions from the April 2015 Board of Trustees Meeting	Décisions importantes de la réunion du Comité d’Administration des Trustees, d’avril 2015
My Reflections after the Book Expo America	Mes pensées sur le Salon américain du livre
The Bogotá International Book Fair	Le Salon international du livre à Bogota
A Cooperative Venture at the Chicago Lit Fest	Une entreprise conjointe à la fête Lit de Chicago
The Foundation's Photo Gallery: Preserving History	La galerie de photos de la Fondation : Préserver l’histoire
What The Urantia Book Means to Me	Ce que Le Livre d’Urantia signifie pour moi - Andrea Barnes
My Quest to Find Answers	Ma quête pour trouver des réponses
Annoucements	Annonces
Volume 9, Issue 3, Sept. 2015	Volume 9, numéro 3, septembre 2015
Welcome & Contact Details	Bienvenue et coordonnées
A Gathering of Readers in Italy	Une réunion de lecteurs en Italie
Noteworthy Decisions from the July 2015 Board of Trustees Meeting	Importantes décisions de la réunion du comité d’administration des Trustees, de juillet 2015
The Highest Joy	La joie la plus élevée
Remembering Luiz Carlos Dolabela Chagas	En souvenir de Luiz Carlos Dolabella Chagas
The Worship Experience at SSS15	L’expérience d’adoration à SSS15
Looking Back at the UAI 2015 Québec Conference	Rétrospective de la conférence de l’AUI de 2015 au Québec
October 12, 1955	Le 12 octobre 1955
Thoughts and Reflections on What The Urantia Book Means to me	Pensées et réflexions sur ce que le Livre d’Urantia signifie pour moi
Volume 9, Issue 4, Dec. 2015	Volume 9, numéro 4, décembre 2015
Welcome & Contact Details	Bienvenue et coordonnées
Urantia Foundation's Year-End Fundraising Match	La collecte de fonds à égalisation de fin d’année de la Fondation Urantia - 2015
Noteworthy Decisions from the October 2015 Board of Trustees Meeting	Décisions importantes de la réunion du comité d’administration des Trustees d’octobre 2015
The Urantia Book at the Parliament of the World's Religions	Le Livre d’Urantia au Parlement des Religions du Monde
Money Matters Matter	Les affaires d’argent ont de l’importance
The Work of the Urantia Book Internet School (UBIS)	Le travail de l’École Internet du Livre d’Urantia (UBIS)
Living a Compassionate Life—A Urantia Foundation Workshop	Vivre une vie de compassion–Un atelier de la Fondation Urantia
Dancing with God: Weaving the Tapestry of the Supreme	Danser avec Dieu : Tisser la tapisserie du Suprême
A Urantia Book Youth Turns Forty	Un jeune Urantien vient d’avoir quarante ans
Volume 10, 2016	Volume 10, 2016
Volume 10, Issue 1, March 2016	Volume 10, Numéro 1, mars 2016
Welcome & Contact Details	Bienvenue et coordonnées
The Urantia Book in Cameroon: Reflections from a Study Group Leader	Le Livre d’Urantia au Cameroun : réflexions d’un dirigeant de groupe d’étude
Noteworthy Decisions from the January 2016 Board of Trustees Meeting	Décisions importantes de la réunion du conseil d’administration des Trustees de janvier 2016
Science Symposium 2016	Le Symposium sur la Science 2016
UBIS: A student's Perspective	UBIS : Le point de vue d’un étudiant
2016 Joint Conference—Time Dwindles and Planning Intensifies	La conférence conjointe de 2016- Le temps diminue et le planning s’intensifie
The Women 's Assembly— an Uplifting Experience	La réunion des femmes - une expérience édifiante
Registration Starts Soon for The Urantia Book Internet School April Trimester	L’enregistrement pour le trimestre d’avril de l’École Internet du Livre d’Urantia débutera bientôt
How The Urantia Book Inspires Giving	Comment le Livre d’Urantia inspire à donner
Volume 10, Issue 2, June 2016	Volume 10, numéro 2, juin 2016
Welcome & Contact Details	Bienvenue et coordonnées
Remaining Relevant: Urantia Fundation Announces Urantia Press	Restant d’actualité : La Fondation Urantia annonce l’Urantia Press
Noteworthy Decisions from the March 2016 Board of Trustees Meeting	Décisions importantes de la réunion du comité d’administration des Trustees de mars 2016
The Revision of the Portuguese Translation of The Urantia Book	La révision de la traduction portugaise du Livre d’Urantia
Reflections on the 2016 Science Symposium	Réflexions sur le Symposium de la Science de 2016
The Summer Conference in San Antonio	La Conférence d’Été de San Antonio
The 2016 Bogotá International Book Fair	La Foire Internationale du Livre de 2016 à Bogota
CosmicCreations—An Outreach Effort	CosmicCreations—Un effort de sensibilisation
What Did, Does, and Will The Urantia Book Mean To?	Ce que le Livre d’Urantia a signifié, signifie et signifiera pour moi ?
Volume 10, Issue 3, Sept. 2016	Volume 10, numéro 3, septembre 2016
Welcome & Contact Details	Bienvenue et coordonnées
A Report on Translations of The Urantia Book	Un rapport sur les traductions du Livre d’Urantia
Noteworthy Decisions from the July 2016 Board of Trustees Meeting	Décisions importantes de la réunion du Comité d’Administration des Trustees de juillet 2016
Volume 10, Issue 4, Dec. 2016	Volume 10, numéro 4, décembre 2016
Welcome & Contact Details	Bienvenue et coordonnées
Stewardship	Gérance
Noteworthy Decisions from the October 2016 Board of Trustees Meeting	Décisions Importantes de la réunion du conseil d’administration des Trustees d’octobre 2016
A New Library of Human Source Books	Une nouvelle bibliothèque d´ouvrages de ressources humaines
The First Conference for Readers of The Urantia Book in Russia	La première conférence de lecteurs du Livre d’Urantia en Russie
2016 European Urantia Conference in Budapest—Who is Jesus?	La conférence européenne Urantia de 2016, à Budapest—Qui est Jésus ?
The Latin American Conference—The Teacher and the Student	La conférence latino-américaine—L’enseignant et l’étudiant
Dancing with God: Embodying the Love of God	Danser avec Dieu : Incarner l’amour de Dieu
Cathy Jones, “Our Cathy”	Cathy Jones~ « Notre Cathy »
Circles of Trust: An Experience in Soul Sharing	Les Cercles de Confiance : Une expérience de partage de l’âme
The World's Best Stories	Les Meilleures Histoires du Monde
Volume 11, 2017	Volume 11, 2017
Volume 11, Issue 1, March 2017	Volume 11, numéro 1, mars 2017
Welcome & Contact Details	Bienvenue et coordonnées
Joint Education Seminar at Urantia Foundation Focuses on Sharing the Teachings	Séminaire éducatif conjoint, à la Fondation Urantia, centré sur le Partage des Enseignements
Noteworthy Decisions from the January 2017 Board of Trustees Meeting	Décisions importantes de la réunion du Comité d’Administration des Trustees de janvier 2017
The Polish Translation After Six Years	La traduction polonaise après six ans
Report from the Finnish Office	Rapport du bureau finlandais
Mission Accomplished—A Urantia Conference in Ghana	Mission accomplie, une conférence Urantia en Guinée
My Experience As a Urantia Book Internet School Facilitator	Mon expérience comme animateur de l’École Internet du Livre d’Urantia
The Girl in the Pink Shirt	La fille en chemisier rose
Dancing with God: Emerging in Sacredness—A Daughters of God Retreat	Danser avec Dieu : Naître en caractère sacré , une retraite des filles de Dieu
Circles of Trust: An Experience in Soul Sharing	Cercles de confiance : une expérience de partage d'âme
The Greatest Stories Ever Told	Les plus grandes histoires jamais racontées
Volume 11, Issue 2, June 2017	Volume 11, numéro 2, juin 2017
Welcome & Contact Details	Bienvenue et coordonnées
Seeding The Urantia Book in the Philippines: Tour Number Three	Semer Le Livre d’Urantia aux Philippines : Troisième voyage
Noteworthy Decisions from the April 2017 Board of Trustees Meeting	Décisions importantes de la réunion du Conseil d’Administration des Trustees d’Avril 2017
Translations and Unity	Traductions et Unité
BookExpo America 2017	Salon du livre américain 2017
The UBIS Experience	L’expérience UBIS
The International Book Fair in Bogotá	Le Salon international du livre à Bogota
God in Man—The Spanish Readers Gather	Dieu en l’homme- le rassemblement des lecteurs espagnols
What Can the Emerging Philosophy of Living Do?	Que peut-il émerger de la Philosophie de vie ?
Spiritual Rebirth—How The Urantia Book Transformed Me	Renaissance spirituelle, comment Le Livre d’Urantia m’a transformé
Announcements	Annonces
Volume 11, Issue 3, Oct. 2017	Volume 11, Numéro 3, octobre 2017
Welcome & Contact Details	Bienvenue et coordonnées
Free Downloads of The Urantia Book at urantia.org	Téléchargements gratuits du Livre d’Urantia sur urantia.org
Noteworthy Decisions from the July 2017 Board of Trustees Meeting	Décisions Importantes de la réunion du Conseil d’Administration des Trustees de juillet 2017
Urantia Foundation's Index of The Urantia Book	L’index du Livre d’Urantia de la Fondation Urantia
Dancing With God: Emerging In Sacredness- A Retreat For Women At Urantia Foundation	Danser avec Dieu : Emerger dans la sagesse, une retraite pour femmes à la Fondation Urantia
The 2018 Urantia Association International Conference	La conférence de l’Association Urantia Internationale de 2018
The IC'17 Children's Program: How I Got By With A Lot Of Help From My Friends!	Le programme pour enfants de IC’17 (conférence internationale) : Comment je m’en suis sortie avec beaucoup d’aide de mes amis !
Signs and Wonders	Signes et Miracles
Ask and You Shall Receive	Demandez et vous recevrez
Volume 11, Issue 4, Dec. 2017	Volume 11, Numéro 4, décembre 2017
Welcome & Contact Details	Bienvenue et coordonnées
Curing Blindness in Ethiopia	Guérir la cécité en Éthiopie
Noteworthy Decisions from the October 2017 Board of Trustees Meeting	Décisions importantes de la réunion du Conseil d’Administration des Trustees d’Octobre 2017
The Spanish Revision Team Visits Urantia Foundation	L’Équipe de la révision espagnole rend visite à la Fondation Urantia
2017 Year-end Match	La collecte de fonds à égalisation de fin d’année 2017
Sending Donations to Urantia Foundation	Envoyer des dons à la Fondation Urantia
A Look into the Future	Un regard dans le futur
A Urantia Book Booth at the Miami Book Fair	Un stand du Livre d’Urantia à la foire du livre de Miami
Season's Greetings: Reflections on True Gifts from The Urantia Book	Joyeuses Fêtes : Réflexions sur les vrais cadeaux du Livre d’Urantia
Volume 12, 2018	Volume 12, 2018
Volume 12, Issue 1, March 2018	Volume 12, Numéro 1, mars 2018
Welcome & Contact Details	Bienvenue et coordonnées
The Revelation Bridge Endowment Fund-Securing the Future for The Urantia Book and Its Teachings	Le fonds de dotation du Pont de la Révélation – sécuriser le futur du Livre d’Urantia et de ses enseignements
Noteworthy Decisions from the January 2018 Board of Trustees Meeting	Décisions importantes de la réunion du Conseil d’Administration des Trustees de janvier 2018
Sending Le Livre d'Urantia to Cameroon	Semer le Livre d’Urantia au Cameroun
Urantia Book Internet School-Fellowship Across the Globe	L’École Internet du Livre d’Urantia — Communauté planétaire
The Urantia Book in Fiji	Le Livre d’Urantia aux îles Fidji
Urantia Association and Urantia Foundation Meet at 533 in Chicago	L’Association Urantia Internationale et la Fondation Urantia se rencontrent au 533 à Chicago
Remembering Larry Watkins—Treasured Server of the Urantia Revelation	Célébration de Larry Watkins – précieux serviteur de la Révélation Urantia
Appreciating Sue Tennant	Appréciation de Sue Tenant
The Pipeline Of Light—Seeding The Urantia Book Worldwide	Le Pipeline de Lumière — Semer Le Livre D’urantia Dans Le Monde Entier
A Way To Be of Service	Une manière de servir
What The Urantia Book Means to Me	Ce que le Livre d’Urantia signifie pour moi
The Urantia Book Fellowship's Summer Study Session 2018	La session d’étude estivale 2018 de la Fellowship du Livre d’Urantia
“Dancing with God—Courageously Living His Love”	Danser avec Dieu — Vivre courageusement son amour
Volume 12, Issue 2, July 2018	Volume 12, numéro 2, juillet 2018
Welcome & Contact Details	Bienvenue et coordonnées
Richard Keeler Retires	Richard Keeler prend sa retraite
Noteworthy Decisions from the April 2018 Board of Trustees Meeting	Décisions importantes de la réunion du Conseil d’Administration des Trustees d’avril 2018
The Parables Book—A Resource for Outreach	Le Livre des Paraboles—Un moyen de sensibiliser
A Knowledgeable Guide to Point the Way—Urantia Foundation's Index	Un guide compétent pour la voie à suivre- l’Index de la Fondation Urantia
Jesus as a Teacher—2018 International Conference in Amsterdam	Jésus comme Enseignant—La Conférence Internationale d’Amsterdam
Ghana—The Teachings Spread with Conferences and Gift Books	Ghana—Les enseignements se propagent par les conférences et les dons de livres
Celebrating Marjorie Reed	Hommage à Marjorie Reed
Spreading The Urantia Book Throughout Italy	Diffusion du Livre d’Urantia en Italie
Announcements	Annonces
Volume 12, Issue 3, Oct. 2018	Volume 12, numéro 3, octobre 2018
Welcome & Contact Details	Bienvenue et coordonnées
A Way to Serve and to Seed-Urantia Foundation Sends 600 Books to Latin America	Une manière de servir et de semer—La Fondation Urantia envoie 600 livres en Amérique Latine
Noteworthy Decisions from 2 the July 2018 Board of Trustees Meeting	Décisions importantes de la réunion du conseil d’administration des Trustees de juillet 2018
Update: Outreach in the Philippines	Mise à jour : Sensibilisation aux Philippines
The Challenges of Translating The Urantia Book	Les défis de traduire le Livre d’Urantia
The Urantia Book Study Group Directory Launched a New Website	Le répertoire des groupes d’étude du Livre d’Urantia lance un nouveau site internet
Reflections of the 2018 Summer Study Session	Réflexions sur la Session d’Etude Estivale de 2018
Urantia Foundation to Attend the 2018 Parliament of the World's Religions	La Fondation Urantia participera au Parlement des Religions du Monde de 2018
What The Urantia Book Means to Me	Ce que le Livre d’Urantia représente pour moi - Khatukhira Bernard
Announcements	Annonces
Volume 12, Issue 4, Dec. 2018	Volume 12, Numéro 4, décembre 2018
Welcome & Contact Details	Bienvenue et coordonnées
It's the Season of Giving	C’est le temps des dons
Noteworthy Decisions from the October 2018 Board of Trustees Meeting	Décisions importantes de la réunion du conseil d' administration des trustees, d'octobre 2018
UBIS Gets a Makeover	UBIS fait peau neuve
Our Experiences at the 2018 Parliament of the World 's Religions	Nos expériences au Parlement des Religions du Monde de 2018
Dancing with God: The Fifth Annual Women's Retreat	Danser avec Dieu : la cinquième retraite annuelle des femmes
Seeding The Urantia Book in Romania	Semer le Livre d’Urantia en Roumanie
What The Urantia Book Means to Me	Ce que le Livre d’Urantia signifie pour moi - Moustapha N’Diaye
Announcements	Annonces
Volume 13, 2019	Volume 13, 2019
Volume 13, Issue 1, April 2019	Volume 13, Numéro 1, avril 2019
Welcome & Contact Details	Bienvenue et coordonnées
Our Brother Richard	Notre frère Richard
Noteworthy Decisions from the January 2019 Board of Trustees Meeting	Décisions importantes de la réunion du Conseil d’administration des Trustees de janvier 2019
The Untold Story of Jesus: A Modern Biography from The Urantia Book	L’Histoire Méconnue de Jésus : Une biographie moderne du Livre d’Urantia
Global Cultural Symposium at Urantia Foundation	Le Symposium Culturel Mondial à la Fondation Urantia
The UBIS Experience—Behind the Scenes	L’expérience UBIS- Dans les coulisses
What The Urantia Book Means to Me 	Ce que le Livre d’Urantia signifie pour moi - Simonas Jurgionis
Announcements	Annonces
Volume 13, Issue 2, July 2019	Volume 13, numéro 2, juillet 2019
Welcome & Contact Details	Bienvenue et coordonnées
Creating Translations out of Love: Urantia Foundation's Quality Process	Créer des traductions par amour : Le processus de qualité de la Fondation Urantia
Noteworthy Board Decisions from the April 2019 Trustees Meeting	Importantes décisions de la réunion du conseil d’administration des Trustees d’avril 2019
Urantia Foundation's Global Cultural Symposium	Le Symposium Culturel Mondial de la Fondation Urantia
My Personal Experience At The Cultural Symposium	Mon expérience personnelle du symposium culturel
Ways to Help Spread the Urantia Revelation	Des façons d’aider à propager la Révélation Urantia
CosmicCreations—Our Service Project	CosmicCreations—Notre projet de service
Celebrating Moussa N'Diaye and Norman Ingram	Hommage à Moussa N’Diaye et Norman Ingram
What The Urantia Book Means to Me	Ce que Le Livre d’Urantia signifie pour moi - Agnès Lazar
Announcements	Annonces
Volume 13, Issue 3, Oct. 2019	Volume 13, Numéro 3, octobre 2019
Welcome & Contact Details	Bienvenue et coordonnées
The Spanish Revision Is Almost Finished	La révision espagnole est presque terminée
Noteworthy Board Decisions from the July 2019 Trustees Meeting	Décisions importantes de la réunion du conseil d’administration des Trustees de juillet 2019
Study Groups and Translations	Groupes d’étude et Traductions
The Second UAI European Conference in Tallinn	La seconde conférence européenne de l’AUI à Tallinn
Remembering Mark Bloomfield	Hommage à Mark Bloomfield
Announcements	Annonces
Volume 13, Issue 4, Dec. 2019	Volume 13, Numéro 4 , décembre 2019
Welcome & Contact Details	Bienvenue et coordonnées
Together We Can Make a Diference	Ensemble nous pouvons faire la différence
Noteworthy Decisions from the October 2019 Trustees Meeting	Décisions importantes de la réunion du Conseil d’Administration des Trustees, d’octobre 2019
My Impressions of the Spanish Revision	Mes impressions sur la révision espagnole
Science Symposium 2019	Le Symposium de la Science de 2019
A Celebration of Souls	Une commémoration d’âmes
The Presence of Urantia Peru at the Cusco International Book Fair 2019	La participation d’Urantia Pérou au salon du livre international de 2019 à Cusco
The Word, the Language, the Dictionary	Le mot, la langue, le dictionnaire
Dancing with God—Our Supreme Calling Retreat	Danser avec Dieu- Notre Retraite de l’Appel Suprême
Seattle Hempfest Report	Un rapport sur le rassemblement de Seattle Hempfest
An Essay on Finding Truth	Un essai sur la découverte de la Vérité
Announcements	Annonces
Volume 14, 2020	Volume 14, 2020
Volume 14, Issue 1, April 2020	Volume 14, numéro 1, avril 2020
Welcome & Contact Details	Bienvenue et coordonnées
A Filipino Translation of The Urantia Book	Une traduction du Livre d’Urantia en philippin
Noteworthy Decisions from 2 the January 2020 Trustees Meeting	Décisions importantes de la réunion des Trustees de janvier 2020
Remembering Carmelo María Martínez Ortiz De Zarate 1947-2020	Hommage à Carmelo Maria Martinez Ortiz de Zarate
Online Education—A Global Mission	Éducation en Ligne – une mission mondiale
The 2019 Urantia Book Conference in the Philippines	La conférence du Livre d’Urantia 2019 aux Philippines
A Story of Three Audiobooks	Une histoire à trois. Livres audio
Sharing The Urantia Book	Partager le Livre d’Urantia
Announcements	Annonces
Volume 14, Issue 2, June 2020	Volume 14, Numéro 2, juin 2020
Welcome & Contact Details	Bienvenue et coordonnées
The Indonesian Translation: A Journey with The Urantia Book	La traduction indonésienne : une aventure avec Le Livre d’Urantia
Updates from the April 2020 Board Meeting	Actualisations de la réunion du Conseil d’administration des Trustees d’Avril 2020
Steve Dreier: A Tribute	Steve Dreier : Un Hommage
Urantia Association's Second 24-Hour Online Event	Le deuxième événement de 24 heures en ligne de l’Association Urantia
What The Urantia Book Means to Me	Ce que Le Livre d’Urantia signifie pour moi - Brad Garner
Announcements	Annonces
Volume 14, Issue 3, Oct. 2020	Volume 14, numéro 3, octobre 2020
Welcome & Contact Details	Bienvenue et coordonnées
The First Chinese Conference: An Unprecedented International Endeavor	La première conférence chinoise : Une initiative internationale sans précédent
Updates from the July 2020 Trustee Meeting	Actualisations de la réunion du Conseil d’administration des Trustees de juillet 2020
The Satisfactions of (Reader) Service	Les joies du service (aux lecteurs)
The Urantia Book Historical Society has a New Archive	La Société Historique du Livre d’Urantia a de nouvelles archives
What The Urantia Book Means to Me	Ce que Le Livre d'Urantia signifie pour moi - Michael Hill
Planned Giving	Les Pensées à Méditer en Français
Announcements	Annonces
Volume 14, Issue 4, Dec. 2020	Volume 14, numéro 4, décembre 2020
Welcome & Contact Details	Bienvenue et coordonnées
Infinite Treasures Are Ours	Les trésors infinis sont à nous
The Standard Reference Text—Historical Context and Purpose	Le texte standard de référence – le contexte historique et son objectif
Updates from the October 2020 Trustee Meeting	Points importants de la réunion des trustees d’octobre 2020
Chinese Conference Generates Enthusiasm for The Urantia Book	La conférence chinoise provoque de l’enthousiasme pour Le Livre d’Urantia
Remembering Carolyn Kendall	En souvenir de Carolyn Kendall
Urantia Book Internet School—an Opportunity for Spiritual Growth and Brotherhood	L’école Internet du Livre d’Urantia — une occasion de croissance spirituelle et de fraternité
Urantia Book Internet School—a Brazilian Experience	L’école Internet du Livre d’Urantia — une expérience brésilienne
What The Urantia Book Means to Me-the Dimensions of God	Ce que Le Livre d’Urantia signifie pour moi — les dimensions de dieu
Announcements	Annonces
Volume 15, 2021	Volume 15, 2021
Volume 15, Issue 1, April 2021	Volume 15, Numéro 1er avril 2021
Welcome & Contact Details	Bienvenue et coordonnées
Springtime for the New El libro de Urantia	Le Printemps du nouveau El libro de Urantia
Updates from the January 2021 Trustee Meeting	Actualisations de la réunion des Trustees de janvier 2021
The Urantia Book in Europe—Our Journey Building a Distribution Network	Le Livre d’Urantia en Europe — Notre périple pour construire un réseau de distribution
Loving Service Spiritual Retreat —The Power of Stories	La retraite spirituelle de service aimant — Le Pouvoir des histoires.
Urantia Foundation Outreach Committee	Le Comité de Sensibilisation de la Fondation Urantia
Dancing with God—Living in Love in Trying Times	Danser avec Dieu — Vivre dans l’amour en ces temps difficiles
New Enhanced English E-book	Nouveau livre électronique en anglais amélioré
Learn About the New Revision of El Libro de Urantia	Apprenez-en davantage sur la nouvelle révision du Libro de Urantia
Volume 15, Issue 2, July 2021	Volume 15, Numéro 2, juillet 2021
Welcome & Contact Details	Bienvenue et coordonnées
Taking It to a New Level: The Urantia Book in Esperanto	Passer au niveau supérieur : Le Livre d’Urantia en Espéranto
Updates from the April 2021 Trustee Meeting	Actualisations de la réunion des Trustees d’avril 2021
My Experiences with the Spanish Revision	Mon expérience avec la révision espagnole
Distributing Het Urantia Boek in the Netherlands and Belgium	La distribution du Livre d’Urantia aux Pays-Bas et en Belgique
Experiencing International Brotherhood through Urantia Book Internet School	L’expérience de la Fraternité Internationale par Le Livre d’Urantia sur Internet
Teamwork: A Virtual Conference Experience	Le travail d’équipe : une expérience de conférence virtuelle
What The Urantia Book Means to Me	Ce que Le Livre d’Urantia signifie pour moi - Zwelakhe Patrick Kubheka
Announcements	Annonces
Volume 15, Issue 3, Sept. 2021	Volume 15, numéro 3, septembre 2021
Welcome & Contact Details	Bienvenue et coordonnées
Maximizing Outreach with an Android App	Maximiser la sensibilisation par une application Androïde
Updates from the July Trustee Meeting	Actualisations de la réunion des Trustees de juillet 2021
A Decade of Quality and Dedication — the Revision of El Libro de Urantia	Une décennie de qualité et de dévouement — la révision de El Libro de Urantia
The Effect of Supply Chains on Book Printing and Distribution	L’impact des chaînes d’approvisionnement sur l’impression des livres et la distribution
The Enduring Legacy of Two Great Teachers	L’héritage durable de deux grands enseignants
A Quadrimillennial Appreciation of Machiventa Melchizedek	Une reconnaissance de quatre millénaires pour Machiventa Melchizedek
Three Concentric Circles — Our Michael Son's Banner	Les trois Cercles Concentriques — La bannière de notre Fils Michaël
Sharing The Urantia Book	Partager Le Livre d’Urantia
What The Urantia Book Means to Me	Ce que Le Livre d’Urantia signifie pour moi - Michelle Heulot
Science Symposium III	Il est encore temps de soumettre une proposition pour le Symposium de la Science III
Volume 16, 2022	Volume 16, 2022
Volume 16, Issue 1, Jan. 2022	Volume 16, numéro 1, janvier 2022
Welcome & Contact Details	Bienvenue et coordonnées
2022 Here We Come!	2022 Nous Voilà !
Updates from the October 2021 Trustee Meeting	Actualisations de la réunion des Trustees d’octobre 2021
The Chinese Translation: An Update	La Traduction Chinoise : une mise à jour
Circling the Globe with UBIS	Faire le tour du monde avec UBIS
My Benelux Esperanto Conference Experience	Mon expérience de la conférence Espéranto du Bénélux
Remembering Irmeli Ivalo-Sjõlie	Hommage à Irmeli Ivalo-Sjölie
Sharing The Urantia Book	Partager Le Livre d’Urantia
What The Urantia Book Means to Me	Ce que Le Livre d’Urantia signifie pour moi - Andrés Rodríguez
Volume 16, Issue 2, March 2022	Volume 16, numéro 2, mars 2022
Welcome & Contact Details	Bienvenue et coordonnées
Ksiega Urantii: How the Polish Translation Came to Be	Ksiega Urantii : comment la traduction polonaise a vu le jour
Updates from the January 2022 Trustee Meeting	Actualisations de la réunion des Trustees de janvier 2022
The Inquiring Greeks: A Chronicle of the Greek Translation of The Urantia Book	Les Grecs investigateurs : une chronique sur la traduction grecque du Livre d’Urantia
Urantia Foundation: Enhancing a Global Movement	La Fondation Urantia : renforcer un mouvement mondial
An Indispensable Partnership: The Pipeline of Light	Un partenariat indispensable : Le Pipeline de Lumière
Collaboration and Spiritual Unity: The Urantia Book Study Group Directory	Collaboration et Unité spirituelle : Le Répertoire des Groupes d’Étude du Livre d’Urantia
Joining the Team at Urantia Foundation	Rejoindre l’équipe de la Fondation Urantia
Sharing The Urantia Book	Partager Le Livre d’Urantia
What The Urantia Book Means to Me	Ce que Le Livre d’Urantia signifie pour moi - Anton Miroshnichenko
Announcements	Annonces
Volume 16, Issue 3, July 2022	Volume 16, numéro 3, juillet 2022
Welcome & Contact Details	Bienvenue et coordonnées
Science: The Interface of Evolution and Revelation	La Science : l’Interface de l’Évolution et de la Révélation
Updates from the April 2022 Trustee Meeting	Actualisations de la réunion des Trustees d’avril 2022
The Cultural Advisory Council Welcomes Brazil	Le Conseil Consultatif Culturel reçoit le Brésil
Urantia Book Internet School—Study Groups for New Readers	L’École Internet du Livre d’Urantia—Les groupes d’étude pour les nouveaux lecteur
Three Ways to Help Spread the Urantia Revelation	Trois façons d’aider à propager la Révélation Urantia
A Tribute to Dr. Marta Elders—Our Love of a Lady	Un hommage au Dr Marta Elders—Notre amour d’une dame
What The Urantia Book Means to Me	Ce que le Livre d’Urantia signifie pour moi - Jeannie Vázquez de Abreu
Announcements	Annonces
Volume 16, Issue 4, Oct. 2022	Volume 16, numéro 4, octobre 2022
Welcome & Contact Details	Bienvenue et coordonnées
Urantia Books across the Globe	Les Livres d’Urantia à travers le monde
Updates from the July 2022 Trustee Meeting	Actualisations de la réunion des Trustees de juillet 2022
Quality TranslationsA 40—Year Process!	Des traductions de qualité—un processus de 40 ans !
The Revelation Flourishes in the Philippines	La Révélation fleurit dans les Philippines
Serving as Trustees of Urantia Foundation	Servir comme Trustee de la Fondation Urantia
The Cultural Advisory Council Welcomes Colombia	Le Conseil Consultatif Culturel reçoit la Colombie
Growing a School out of Love for the Revelation	Développer une École par Amour de la Révélation
Sharing The Urantia Book	Partager Le livre d’Urantia - Sherry Cathcart Chavis
What The Urantia Book Means to Me	Ce que Le Livre d’Urantia signifie pour moi - Constance “Konni” Wallach
Announcements	Annonces
Volume 16, Issue 5, Dec. 2022	Volume 16, Numéro 5, décembre 2022
Welcome & Contact Details	Bienvenue et coordonnées
The Assurance of God's Unbreakable Promises	La garantie des promesses inébranlables de Dieu
Updates from the October 2022 Trustee Meeting	Actualisations de la réunion des Trustees d’octobre 2022
The Cultural Advisory Council Welcomes Poland	Le Conseil Consultatif Culturel accueille la Pologne
Nurturing the Revelation in the Philippines	Cultiver la Révélation aux Philippines
Our Urantia Book Stand at the Cali, Colombia Bookfair	Notre stand du Livre d’Urantia au salon du livre, à Cali en Colombie
Third European Conference of Urantia Book Readers—Overcoming Materialism and Enlightening Europe	La troisième Conférence Européenne des lecteurs du Livre d’Urantia — Surmonter le Matérialisme et Éclairer l’Europe
Sharing The Urantia Book	Partager Le Livre d’Urantia - l’Équipe de Réponses aux Demandes des Prisonniers (PIRT)
What The Urantia Book Means to Me	Ce que Le Livre d’Urantia représente pour moi - Obol Sunday Jimmy
Announcements	Annonces
Volume 17, 2023	Volume 17, 2023
Volume 17, Issue 1, March 2023	Volume 17, Numéro 1, mars 2023
Welcome & Contact Details	Bienvenue et coordonnées
The Mustard Seed Grants Program	Le Programme de Subventions de la Graine de Moutarde
Updates from the January 2023 Trustee Meeting	Actualisations de la réunion des Trustees de janvier 2023
An Epochal Plan	Un plan d’époque
Urantia Book International School Virtual Study Groups	Les groupes d’étude virtuels de l’École Internationale du Livre d’Urantia
Remembering Tonia Baney	À la mémoire de Tonia Baney, Ancienne Directrice Exécutive, De La Fondation Urantia
What The Urantia Book Means to Me	Ce que Le Livre d’Urantia signifie pour moi - Mirela Gradinariu-Kelpin
Announcements	Annonces
Volume 17, Issue 2, June 2023	Volume 17, Numéro 2, juin 2023
Welcome & Contact Details	Bienvenue et coordonnées
Remembering Seppo Kanerva—a Letter to a Brother, Friend, and Colleague	À la mémoire de Seppo Kanerva - Une lettre à un frère, un ami et un collègue
Updates from the April 2023 Trustee Meeting	Actualisations de la réunion des Trustees d'avril 2023
“Spreading the Good News” Tour	Tournée “Répandre la bonne nouvelle”
Wikipedia and The Urantia Book	Wikipedia et le Livre d'Urantia
Remembering John Hales	À la mémoire de John Hales
Remembering Paula Padilla	À la mémoire de Paula Padilla
What The Urantia Book Means to Me - Luis Costa	Ce que le Livre d'Urantia signifie pour moi - Luis Costa
Announcements	Annonces
Volume 17, Issue 3, October 2023	Volume 17, Numéro 3, octobre 2023
Welcome & Contact Details	Bienvenue et coordonnées
The Philippines—Energized by the Spirit of Revelation	Les Philippines — vivifiées par l'Esprit de Révélation
Updates from the July 2023 Trustee Meeting	Actualisations de la réunion des Trustees de juillet 2023
Contagious Love—A Mustard Seed Grows in Nigeria	L’Amour contagieux - Une graine de moutarde croît au Nigeria
The Parliament of the World’s Religions	Le Parlement des religions du monde
Remembering Nancy Johnson	À la mémoire de Nancy Johnson
What The Urantia Book Means to Me - Doug McKeever	Ce que le Livre d'Urantia signifie pour moi - Doug McKeever
Announcements	Annonces
Volume 17, Issue 4, December 2023	Volume 17, Numéro 4, décembre 2023
Welcome & Contact Details	Bienvenue et coordonnées
A Path to World Peace and Progress	Une voie vers la paix et le progrès dans le monde
Updates from the October 2023 Trustee Meeting	Actualisations de la réunion des Trustees d'octobre 2023
Doing Good to Others—Outreach in the Philippines	Faire du bien aux autres — La Sensibilisation aux Philippines
Urantia Book International School—A Silver Jubilee	École Internationale du Livre d'Urantia - Jubilé d'argent
Reflections from the Cultural Advisory Council	Réflexions du Conseil Consultatif Culturel
Memories of the Third Latin American Urantia Conference in Mexico	Souvenirs de la troisième conférence Urantia latino-américaine au Mexique
What The Urantia Book Means to Me - Yeesook Yoon	Ce que le Livre d'Urantia Signifie pour Moi - Yeesook Yoon
Announcements	Annonces
Volume 18, 2024	Volume 18, 2024
Volume 18, Issue 1, March 2024	Volume 18, numéro 1, mars 2024
Welcome & Contact Details	Bienvenue et coordonnées
A Celebration of the Chinese Translation—Now Published on Urantia Foundation’s Website	Célébration de la traduction chinoise — publiée maintenant sur le site de la Fondation Urantia
Updates from the January 2024 Trustee Meeting	Actualisation de la réunion des trustees de janvier 2024
The Untold Story of Jesus—Coming Soon in Paperback!	The Untold Story of Jesus — Bientôt en livre broché !
The Cultural Advisory Council Welcomes Uganda	Le Conseil Consultatif Culturel accueille l'Ouganda
Remembering Dorothy Elder	À la mémoire de Dorothy Elder
Revelation Outreach in Uganda	Dissémination de la Révélation en Ouganda
What The Urantia Book Means to Us	Ce que Le Livre d'Urantia signifie pour nous - Zofia and Jan Michniewicz
Announcements	Annonces
Volume 18, Issue 2, July 2024	Volume 18, numéro 2, juillet 2024
Welcome & Contact Details	Bienvenue et coordonnées
Urantia Foundation Has a New Website!	La Fondation Urantia a un nouveau site web !
Updates from the April 2024 Trustee Meeting	Actualisation de la réunion des trustees d'avril 2024
Urantia Foundation Visits Taiwan	La Fondation Urantia en visite à Taïwan
The Cultural Advisory Council Welcomes South Korea	Le Conseil Consultatif Culturel accueille la Corée du Sud
2023 Mustard Seed Grant Projects (Round 2)	Projets de subventions « Semence de moutarde » 2023 (2e cycle)
Bogotá Urantia Association at FILBO 2024	Bogota à la FILBO 2024
What The Urantia Book Means to Me	Ce que Le Livre d'Urantia signifie pour moi
Announcements	Annonces
Volume 18, Issue 3, October 2024	Volume 18, numéro 3, octobre 2024
Welcome & Contact Details	Bienvenue et coordonnées
Reflections on the Taiwan Conference	Réflexions sur la conférence de Taïwan
Updates from the July 2024 Trustee Meeting	Actualisation de la réunion des Trustees de juillet 2024
Passing the Torch—Change Is in the Air at Urantia Book International School	Passer le flambeau ─Il y a du changement dans l’air à l'École Internationale du
The Cultural Advisory Council Welcomes Chile	Le Conseil Consultatif Culturel accueille le Chili
The Marriage and Family Adventure! An Online Symposium	L'Aventure du Mariage et de la Famille ! Un symposium en ligne
What The Urantia Book Means to Me	Ce que Le Livre d'Urantia signifie pour moi
Announcements	Annonces
Volume 18, Issue 4, December 2024	Volume 18, numéro 4, décembre 2024
Welcome & Contact Details	Bienvenue et coordonnées
The Urantia Book—Invest in a Brighter Future!	Le Livre d'Urantia — Investissez dans un meilleur avenir !
Updates from the October 2024 Trustee Meeting	Actualisations de la réunion des Trustees d'octobre 2024
A Fond Farewell to the Finnish Branch Office	Un chaleureux adieu à la succursale finlandaise
The Cultural Advisory Council Welcomes Ethiopia	Le Conseil Consultatif Culturel accueille l'Éthiopie
Mustard Seed Grant Project—Urantia Book Outreach in Nigeria	Le Projet de Subvention de la Graine de Moutarde — La diffusion du Livre d'Urantia au Nigéria
Mustard Seed Grant— 2024 Nigerian Urantia Conference	Subvention de la Graine de Moutarde — La Conférence d'Urantia 2024 au Nigeria
The Urantia Book Featured at Awaken Wellness Fair	Le Livre d'Urantia presenté au salon Awaken Wellness
What The Urantia Book Means to Me	Ce que Le Livre d'Urantia signifie pour moi
Announcements	Annonces
Volume 19, 2025	Volume 19, 2025
Volume 19, Issue 1, April 2025	Volume 19, numéro 1, avril 2025
Welcome & Contact Details	Bienvenue et coordonnées
Looking Ahead: The Spanish Translations of El libro de Urantia	Dans l’avenir: Les traductions espagnoles de El libro de Urantia
Updates from the January 2025 Trustee Meeting	Actualisations de la réunion des Trustees de janvier 2025
The Importance of Planned Giving: Leaving a Lasting Legacy	L'importance des dons planifiés : Laisser un héritage durable
Volunteers—a Priceless Gift!	Les bénévoles : un cadeau inestimable !
Adventures in Construction at 533 West Diversey Parkway	Péripéties de construction au 533 West Diversey Parkway
What The Urantia Book Means to Me	Ce que Le Livre d'Urantia signifie pour moi
Announcements	Annonces