Index of ANZURA “The Arena” articles	Index des articles d'ANZURA « L'Arène »
2019	2019
The Arena – Summer 2019	L'Aréna – Été 2019
The Arena – Summer 2019 — Newsletter	L'Aréna – Été 2019 — Newsletter
President’s Report – December 2019	Rapport du Président – Décembre 2019
Annual Conference Auckland New Zealand 2020	Conférence annuelle Auckland Nouvelle-Zélande 2020
Canberra 2019 Conference Report	Compte-rendu de la conférence de Canberra 2019
Growing the Supreme	Cultiver le suprême
Mind Over Matter – Spirit Over Mind	Le mental sur la matière – L'esprit sur le mental
As the Spirit Moves You	Comme l'Esprit vous pousse
The Ascension Plan	Le plan d'ascension
New Zealand Corner – Summer 2019	Coin de la Nouvelle-Zélande – Été 2019
The Inner World of Mankind	Le monde intérieur de l'humanité
River of Life	Rivière de la vie
The Arena – Autumn 2019	L'Arène – Automne 2019
The Arena – Autumn 2019 — Newsletter	L'Arène – Automne 2019 — Newsletter
President Report – Autumn 2019	Rapport du Président – Automne 2019
ANZURA’s Conference Canberra 2019	Conférence ANZURA Canberra 2019
2019 National Study Day	Journée nationale d'étude 2019
On the Cosmic Background	Sur le fond cosmique
Living the Ascension Plan in Terrestrial Human Experience	Vivre le Plan d'Ascension dans l'Expérience Humaine Terrestre
New Zealand Corner – Autumn 2019	Coin de la Nouvelle-Zélande – Automne 2019
Urantia Towards Light & Life	Urantia vers la lumière et la vie
Poem by Leith	Poème de Leith
The Arena – Winter 2019	L'Aréna – Hiver 2019
The Arena – Winter 2019 — Newsletter	L'Aréna – Hiver 2019 — Newsletter
President Report – Winter 2019	Rapport du Président – Hiver 2019
Conference Reminder – Time to Register!	Rappel de la conférence – Il est temps de s’inscrire !
Study Day 2019 – Reflections	Journée d'étude 2019 – Réflexions
New Zealand Corner – Winter 2019	Coin de la Nouvelle-Zélande – Hiver 2019
Farewell Mark Bloomfield	Adieu Mark Bloomfield
Our Educational Imperative – A Strategy for the Coming Decades	Notre impératif éducatif – Une stratégie pour les décennies à venir
Proclaiming the Gospel with Power in the 21st Century	Proclamer l'Évangile avec puissance au 21e siècle
A New Approach to Revelation	Une nouvelle approche de la révélation
Conference 2004 Preamble – Echoes of Eden	Préambule de la conférence 2004 – Les échos de l'Eden
Existentialism in Australia and New Zealand	L'existentialisme en Australie et en Nouvelle-Zélande
Shaking Hands – a Poem	Serrer la main – un poème
2020	2020
The Arena – Spring 2020	L'Aréna – Printemps 2020
The Arena – Spring 2020 — Newsletter	L'Aréna – Printemps 2020 — Newsletter
President’s Report – Spring 2020	Rapport du président – Printemps 2020
Virtual ANZURA Annual Conference 2020	Conférence annuelle virtuelle de l'ANZURA 2020
The Parable of the Sower	La parabole du semeur
Where are the Daughters of God?	Où sont les Filles de Dieu ?
Editor’s Notebook	Carnet de l’éditeur
The Temple Deep Clean	Nettoyage en profondeur du temple
Creative Imagination in Prayer and Worship	L'imagination créatrice dans la prière et le culte
Are You Lonesome Tonight?	Es-tu seul ce soir ?
Business on Urantia	Les affaires sur Urantia
August 21 – a Poem	21 août – un poème
The Stillness – a Poem	Le silence – un poème
The Arena – Summer 2020	L'Aréna – Été 2020
The Arena – Summer 2020 — Newsletter	L'Aréna – Été 2020 — Newsletter
President’s Report – Summer 2020	Rapport du président – Été 2020
Language Matters	La langue est importante
Post Covid 19 Spirituality	Spiritualité post-Covid 19
A Bit of History	Un peu d'histoire
Ancient Orvonton, and a Young Cosmic Web	L'ancien Orvonton et une jeune toile cosmique
Universal Ethics – Concepts from The Urantia Book	Éthique universelle – Concepts du Livre d’Urantia
Think Alike – Necessary or Unnecessary?	Penser de la même façon : nécessaire ou inutile ?
The Mind Arena of Choice	L'arène mentale du choix
Amarantos	Amarante
The Arena – Autumn 2020	L'Arène – Automne 2020
The Arena – Autumn 2020 — Newsletter	L'Arène – Automne 2020 — Newsletter
President’s Report – Autumn 2020	Rapport du Président – Automne 2020
Virtual Study Groups and Conferences	Groupes d'étude et conférences virtuelles
Workshop Summary: Spirit in Society, Overcoming Resistance	Résumé de l'atelier : L'esprit dans la société, vaincre la résistance
Other and Higher Frames	Autres cadres et cadres supérieurs
Disease and Immunity in Relation to the Urantia Book	Maladie et immunité en relation avec le Livre d'Urantia
Fear Not	N'ayez pas peur
New Zealand Corner – Autumn 2020	Coin de la Nouvelle-Zélande – Automne 2020
The Apostle Matthew	L'apôtre Matthieu
2021	2021
The Arena – Summer 2021	L'Aréna – Été 2021
The Arena – Summer 2021 — Newsletter	L'Aréna – Été 2021 — Newsletter
President’s Report – Summer 2021	Rapport du président – Été 2021
2022 Anzura Annual Conference	Conférence annuelle d'Anzura 2022
2021 ANZURA Virtual Conference Report	Rapport de la conférence virtuelle ANZURA 2021
We Are, Because I AM	Nous sommes, parce que je suis
The Stability of Goodness	La stabilité de la bonté
Where Are They All?	Où sont-ils tous ?
Video Part 4D: Ancient Orvonton, and a Young Cosmic Web	Vidéo Partie 4D : L'ancien Orvonton et une jeune toile cosmique
The Tree of Life – Myth or Fact	L’arbre de vie – mythe ou réalité
The Arena – Winter 2021	L'Aréna – Hiver 2021
The Arena – Winter 2021 — Newsletter	L'Aréna – Hiver 2021 — Newsletter
President’s Report – Winter 2021	Rapport du président – Hiver 2021
Sydney Conference Reminder – 2021	Rappel de la conférence de Sydney – 2021
Study Day 2021 – Reflections	Journée d'étude 2021 – Réflexions
Mining the Archives	Exploitation des archives
Application of Scientific Thinking…	Application de la pensée scientifique…
Recent Developments in the Astrophysics Sector	Développements récents dans le secteur de l'astrophysique
The Challenges of Diversity	Les défis de la diversité
True Success	Le vrai succès
New Zealand Corner	Coin de la Nouvelle-Zélande
2022	2022
The Arena – Summer 2022	L'Aréna – Été 2022
The Arena – Summer 2022 — Newsletter	L'Aréna – Été 2022 — Newsletter
President’s Report – Summer 2022	Rapport du président – Été 2022
2023 Annual Conference in Sydney	Conférence annuelle 2023 à Sydney
2022 ANZURA Annual Conference Report	Rapport de la conférence annuelle ANZURA 2022
Walking the R.O.P.E – An Invitation to Intimacy with God	Marcher sur la R.O.P.E – Une invitation à l’intimité avec Dieu
The Religion of Jesus	La religion de Jésus
The Ultimate Human Experience	L'expérience humaine ultime
New Zealand Corner	Coin de la Nouvelle-Zélande
The Arena – Winter 2022	L'Aréna – Hiver 2022
The Arena – Winter 2022 — Newsletter	L'Aréna – Hiver 2022 — Newsletter
Presidents Report – Winter 2022	Rapport du président – Hiver 2022
Countdown to Tassie Conference	Compte à rebours pour la conférence de Tasmanie
National Study Day Reflections	Réflexions sur la Journée nationale d'étude
Urantia Book Presentation	Présentation du Livre d'Urantia
Reflections of Body, Mind and Psychic Expo	Exposition Réflexions sur le corps, l'esprit et le psychisme
Doing According to the Urantia Papers	Agir selon les Livres d'Urantia
2023	2023
The Arena – Winter 2023	L'Aréna – Hiver 2023
The Arena – Winter 2023 — Newsletter	L'Aréna – Hiver 2023 — Infolettre
President’s Report – Winter 2023	Rapport du président – Hiver 2023
2023 Annual Conference in Sydney Update	Mise à jour de la conférence annuelle 2023 à Sydney
Unity – Harmony Within Diversity of Experience and Belief	Unité – Harmonie dans la diversité des expériences et des croyances
Feelings Too Deep for Words	Des sentiments trop profonds pour être exprimés par des mots
Faith-Trust in the Goodness of God	Foi-Confiance en la bonté de Dieu
Spiritual Practices – an Invitation to Intimacy with God	Pratiques spirituelles – une invitation à l’intimité avec Dieu
Activity Report from a Urantia Book Student	Rapport d'activité d'un étudiant du Livre d'Urantia
On the Revelatory Status	Sur le statut révélateur
New Zealand Corner	Coin de la Nouvelle-Zélande
Korean Readers’ Conference	Conférence des lecteurs coréens