Index of Urantia Book Fellowship Herald articles	Index des articles du Urantia Book Fellowship Herald
Volume 1, Number 1, 1998 (Fall)	Volume 1, numéro 1, 1998 (automne)
On the Brink of the Most Amazing and Enthralling Epoch	À l’aube de l’époque la plus étonnante et la plus passionnante
Let Your Soul Decide	Laissez votre âme décider
The Urantia Papers From a Jewish Perspective	Les Cahiers d'Urantia d'un point de vue juif
The Concepts of Trust and Hope in The Urantia Book	Les concepts de confiance et d'espoir dans le Livre d'Urantia
Unity	Unité
48 Chromosomes - Are We Asking the Right Questions?	48 Chromosomes : posons-nous les bonnes questions ?
Volume 1, Number 2, 1999 (Spring)	Volume 1, numéro 2, 1999 (printemps)
The Challenge of the 21st Century	Le défi du 21e siècle
On Facing Millennial Change	Face au changement millénaire
Magisterial Missions	Missions magistrales
Springtime: A Study of the Future	Le printemps : une étude du futur
Whither Goest Thou, Woman?	Où vas-tu, femme ?
The Seven Psychic Circles	Les sept cercles psychiques
On Removing The Barrier To A Civilized Discussion Of Eugenics	Sur la suppression des obstacles à une discussion civilisée sur l’eugénisme
The basket	Le panier
Time and time out	Temps et temps mort
Volume 2, Number 1, 1999 (Winter)	Volume 2, numéro 1, 1999 (hiver)
The Family: Birthplace of Cosmic Citizens	La famille : lieu de naissance des citoyens cosmiques
An Expression of Cosmic Worship	Une expression du culte cosmique
Two Cosmologies — Astronomy and The Urantia Book	Deux cosmologies — L'astronomie et le Livre d'Urantia
Reflections on cosmic citizenship	Réflexions sur la citoyenneté cosmique
The Dual Nature of Supremacy	La double nature de la suprématie
Poem by Emily Bronte	Poème d'Emily Brontë
Volume 2, Number 2, 2000 (Summer)	Volume 2, numéro 2, 2000 (été)
Millenial Prayer	Prière millénaire
Thinking About Tomorrow	Penser à demain
Restated in Modern Phraseology	Reformulé dans une phraséologie moderne
Scientific Predictions of The Urantia Book - Part II	Prédictions scientifiques du Livre d'Urantia — Partie II
“I Will Tell Them A Story”	«Je vais leur raconter une histoire»
The Science of Parenting	La science de la parentalité
The Ethics of Genetic Control and Social Engineering	L'éthique du contrôle génétique et de l'ingénierie sociale
The Intellectual Role of The Urantia Book	Le rôle intellectuel du « Livre d'Urantia »
Volume 3, Number 1, 2001 (Summer)	Volume 3, numéro 1, 2001 (été)
A Source Study Of “Instruction For Teachers And Believers”	Une étude source de « l’instruction pour les enseignants et les croyants »
Show Us A Miracle!	Montrez-nous un miracle !
Universal Religion: An Interfaith Presentation	Religion universelle : une présentation interconfessionnelle
Ethical Eugenics: A Modest Proposal For The 21st Century	Eugénisme éthique : une modeste proposition pour le 21e siècle
Last Mountain In Vancouver	Dernière montagne à Vancouver
Volume 4, Number 1, 2002 (Summer)	Volume 4, numéro 1, 2002 (été)
Reflections on the Urantia Movement in 2002	Réflexions sur le Mouvement Urantia en 2002
Centering — A Method of Divine Embrace	Centrage - Une méthode d'étreinte divine
Eugenics and The Urantia Book: Another Perspective	L'eugénisme et le Livre d'Urantia : une autre perspective
Revelatory Mouthpiecing	Embouchure révélatrice
Faith Wiring in the Brain	Câblage de la foi dans le cerveau
In Search of the Error So Great	À la recherche de l'erreur si grande
Jesus' Miracles and the Father's Will	Les miracles de Jésus et la volonté du Père
Not what we give...but what we share...	Pas ce que nous donnons... mais ce que nous partageons...
A Demystification and Redefinition of Cult	Une démystification et une redéfinition du culte
Religious Practice and the Urantia Revelation	Pratique religieuse et révélation Urantia
The Gift of Tolerance	Le don de la tolérance
Volume 5, Number 1, 2003 (Summer)	Volume 5, numéro 1, 2003 (été)
Evening Prayer	Prière du soir
A Jewish Girl Finds Jesus	Une jeune fille juive trouve Jésus
Prayer from another world	Prière d'un autre monde
Ruminations on Revelation	Réflexions sur la Révélation
Safeguarding the Symbols of Urantian Faith	Sauvegarder les symboles de la foi urantienne
When Belief Becomes Faith	Quand la croyance devient foi
The Patterns of Revelation	Les modèles de révélation
The Difficulty of Being Objective	La difficulté d’être objectif
Words of Wisdom	Paroles de sagesse
Closed Circle or Open Book	Cercle fermé ou livre ouvert ?
The Origin of the Spiritual Fellowship	L'origine de la communion spirituelle
A Dialogue About The Kingdom	Un dialogue sur « Le Royaume des Cieux »
Anti-Terror Treatise	Traité antiterroriste
Thy Kingdom Come	Que ton règne vienne
Volume 5, Number 2, 2004 (Summer)	Volume 5, numéro 2, 2004 (été)
Illumination/Transformation	Illumination / Transformation
An Essay on Hope	Un essai sur l'espoir
The Soul’s Expression	L'expression de l'âme
The Rise of Spiritual Technology	L'essor de la technologie spirituelle
Meditation in The Urantia Book, Jesus Style	Méditation dans le Livre d'Urantia — À la manière de Jésus
The Art of Marriage	L'art du mariage
Room In My Heart	Chambre dans mon coeur
A Trace of God	Une trace de Dieu
The Golden Rule in Business	La règle d'or en affaires
Volume 6, Number 1, 2005 (Summer)	Volume 6, numéro 1, 2005 (été)
The Next Fifty Years: Dissemination	Les cinquante prochaines années
The New Revelation of the Living Jesus	La nouvelle révélation de Jésus vivant
Wonderment and revelation	Émerveillement et révélation
On Removing The Barrier to a Civilized Discussion Of Eugenics	Sur la suppression des obstacles à une discussion civilisée sur l'eugénisme
Becoming a Universe-Conscious Citizen	Le défi des cinquante prochaines années...
At Home In The Universe	À la maison dans l'univers
Pattern of Unity	Modèle d'unité
Journey to India: Legacy of the Sethite Teachers	Voyage en Inde
Thoughts About the Future of our Urantia Community	Réflexions sur l'avenir de notre communauté Urantia
Legacy in Peril: Children and the Urantia Community	Un héritage en péril
Putting the Teachings into Action	Mettre en action les enseignements du Livre d’Urantia à travers la philosophie intégrale
Science Cannot Replace Religion	La science ne peut pas remplacer la religion
A Reed Singing	Un chant de roseau
Volume 7, Number 1, 2006 (Summer)	Volume 7, numéro 1, 2006 (été)
Guardian Angels	anges gardiens
Youth and The Urantia Book	La jeunesse et le Livre d'Urantia
Prophecy and The Urantia Book	La prophétie et le Livre d'Urantia
Serving: A Cookbook for the Soul	Servir – Un livre de recettes pour l’âme
What is Personality?	Qu'est-ce que la personnalité ?
The Coming Scientific Validation of The Urantia Book	La prochaine validation scientifique du Livre d'Urantia
Volume 8, Number 1, 2007 (Summer)	Volume 8, numéro 1, 2007 (été)
Amazing Human Aspects of Epochal Revelation	Aspects humains étonnants de la révélation d’époque – Vérité contre vérité. Fait
Archangels: Agents of Epochal Change	Archanges – Agents du changement d’époque
IC 08 —The Thrill of Loving Service	IC 08—Le frisson du service aimant
Year 2006 Update on The Coming Scientific Validation of The Urantia Book	Mise à jour de l'année 2006 sur la validation scientifique à venir du Livre d'Urantia
Participatory Evolution	Évolution participative
Personality and Man	Personnalité et homme
The Golden Rule	La règle d'or
Science Fiction for Agondonters	Science-fiction pour les agondontaires
Loving Service	Service affectueux
The Kingdom and the Supreme	Le Royaume et le Suprême – Aperçus pour simplifier la compréhension du Livre d’Urantia
Volume 9, Number 1, 2008 (Summer)	Volume 9, numéro 1, 2008 (été)
Celestial Ministry: Seen and Unseen	Ministère Céleste : Origine, Nature et Destin Vus et Invisibles
The Supreme and Outreach	Le Suprême et la Sensibilisation
Guess Who's Coming Next?	Devinez qui viendra ensuite ?
A Missionary Experience in Turkey	Une expérience missionnaire en Turquie
You Be The Book	Tu es le livre
The Start of a Worthy New Tradition	Le début d’une nouvelle tradition digne
The Significance of the Sevenfold Bestowal Career	La signification de la carrière d’effusion septuple de Christ Micaël
The Urantia Book Is Not What It Used To Be	Le Livre d'Urantia n'est plus ce qu'il était
Law is Life Itself	« La loi, c’est la vie elle-même… »
Moral Cosmic Citizenship	Citoyenneté cosmique morale
The Roots of Morality	Les racines de la moralité
Casting Pearls Before Personality	Couler des perles avant la personnalité
A Good Way For Us To Live Our Lives	Une bonne façon pour nous de vivre notre vie
Volume 10, Number 1, 2009 (Summer)	Volume 10, numéro 1, 2009 (été)
In Search of the Historical Onamonalonton	À la recherche de l’Onamonalonton historique
The Role of Emotions and Feelings on an Evolutionary World	Le rôle des émotions et des sentiments dans un monde évolutif
Joy in the Worm Bin	La joie dans la poubelle à vers
Ten Lessons from the Vineyard	Dix leçons de moins du vignoble
Solar System Discoveries that Corroborate The Urantia Book	Découvertes du système solaire qui corroborent le Livre d’Urantia
The Book - a Poem	Le livre - un poème
A Lesson from a Mouse	Une leçon d'une souris
The Third Cosmic Circle	Le troisième cercle cosmique
Becoming an Effective Missionary Evangel	Devenir un évangélique missionnaire efficace
The Limitless Spectrum of Education	Le spectre illimité de l’éducation
Urantia University - U2	Université Urantia - U2
Our Creative Deities—A Supreme Relationship	Nos divinités créatrices – Une relation suprême
Volume 11, Number 1, 2010 (Summer)	Volume 11, numéro 1, 2010 (été)
The World is Not Coming to an End	Le monde ne touche pas à sa fin
Religion of Experience vs. Religion of Authority	Religion de l’expérience versus religion de l’autorité
God Consciousness	Conscience divine
The Urantia Book, Human Concepts, and Revelatory Validation	Le Livre d'Urantia, les concepts humains et la validation révélatrice
Understanding the Relation of Love to the Mind	Comprendre la relation entre l'amour et l'esprit
Cosmic Socialization and Planetary Citizenship	Socialisation cosmique et citoyenneté planétaire
Testimonial of One Second-Generation Urantian	Témoignage d'un Urantien de deuxième génération
The Problem of Business	Le problème des affaires
Crouching Deity/Hidden Supreme	Divinité accroupie / Suprême caché
We Are the Creatures Who Carry the Life	Nous sommes les créatures qui portent la vie
Volume 11, Number 2, 2011 (Summer)	Volume 11, numéro 2, 2011 (été)
The First Epochal Revelation in American Indian Traditions	La première révélation d'époque dans les traditions amérindiennes
The Power of The Name of Jesus	La puissance du nom de Jésus
Machiventa Melchizedek: One of History's Mysteries	Machiventa Melchizédek : l'un des mystères de l'histoire
“Nearer, My God, to Thee” Getting Closer to God	« Plus près, mon Dieu, de toi » Se rapprocher de Dieu
One Man's Tour Through The Evolutionary Debate	Tour d’un homme à travers le débat évolutionniste
One in Ten Million	Un sur dix millions
Volume 12, Number 1, 2012 (Summer)	Volume 12, numéro 1, 2012 (été)
Souls on Purpose: The Personal Creed Project	Souls on Purpose : le projet Personal Creed et le Core Drive
Evolutionary Spirituality	Spiritualité évolutionniste
Urantia, 606 of Satania: Concerning the Inhabited Worlds of the Satania System	Urantia, 606 de Satania
Perfecting, Neuroplasticity, and the Supreme Actualizing	Perfectionnement, Neuroplasticité et Actualisation Suprême
Race and The Urantia Book	La Race et le Livre d'Urantia
Religion of Experience vs Religion of Authority	Religion de l'expérience contre religion de l'autorité
The Forgotten Urantian: Dr. Lena Sadler	« The Urantian » oublié : Dr Lena Celestia (Kellogg) Sadler
Cosmology in the Light of The Urantia Book	La cosmologie à la lumière du Livre d'Urantia
Volume 13, Number 1, 2013 (Summer)	Volume 13, numéro 1, 2013 (été)
Spiritual Genetics	Génétique spirituelle
Religion of One	Religion d'Un
A Cosmology of Race	Une cosmologie de la race
Exploring the Inner Life	Explorer la vie intérieure
Spiritual Faith, Incertainty and Cosmic Citizenship	Foi spirituelle, incertitude et citoyenneté cosmique
Moods, Music and Magic of The Urantia Book	Ambiances, musique et magie du Livre d'Urantia
A Statistical Test of the Hypothesis the That Urantia Book was authored by a Human Being	Un test statistique de l'hypothèse selon laquelle le Livre d'Urantia a été écrit par des êtres humains
Volume 14, Number 1, 2014 (Summer)	Volume 14, numéro 1, 2014 (été)
The Rehabilitation of Urantia	La réhabilitation d'Urantia
The Journey Following Mortal Death	Le voyage après la mort mortelle
Pursuing Supremacy: How Might the Master Seraphim and Human Beings Collaborate?	À la recherche de la suprématie : comment les maîtres séraphins et les êtres humains pourraient-ils collaborer ?
Urantian Language and the Preservation of Meaning	Le langage urantien et la préservation du sens
Origin, Nature, Ministry, and Destiny of Thought Adjusters	Origine, nature, ministère et destinée des ajusteurs de pensée
Spiritual Unity	Unité spirituelle
Prayer? Why Bother?	Prière ? Pourquoi s'embêter ?
Volume 15, Number 1, 2015 (Summer)	Volume 15, numéro 1, 2015 (été)
Effective Study Group Leadership	Leadership efficace des groupes d’étude : éclairer la voie
Can We Have a Universal Standard of Morality	Pouvons-nous avoir une norme universelle de moralité ?
Destiny of the Master Michaels?	Destin du Maître Michaels
The Urantia Book and Its Mission	Le Livre d'Urantia et sa mission
Is The Urantia Book a Sacred Text	Le Livre d'Urantia est-il un texte sacré ?
Sixty-Four Original Urantia Book Concepts	Soixante-quatre concepts originaux du Livre d’Urantia
Society Evolving: Chaos, Progress, and Order	La société en évolution : chaos, progrès et ordre
The Importance of Christian Ministry	L'importance du ministère chrétien
Volume 16, Number 1, 2016 (Summer)	Volume 16, numéro 1, 2016 (été)
A Circle of Kindred Spirits	Un cercle d'esprits apparentés
Listen Up Grandparents and YaYAs	Écoutez les grands-parents et les YaYA
Early Persecutions of Jesus’ Followers and Dispersion of the Apostles	Premières persécutions des disciples de Jésus et dispersion des apôtres
Thoughts on the Bestowals of Personality and the Thought Adjuster	Réflexions sur les dons de personnalité et l'ajusteur de pensée
Mindedness and Spirituality, Comments on the Absolutes	Esprit et spiritualité, commentaires sur les absolus
Why Should You Support a Urantia Organization Like The Urantia Book Fellowship?	Pourquoi devriez-vous soutenir une organisation Urantia comme la Urantia Book Fellowship ?
Top/Down	De haut en bas
Healing Meditation	Méditation de guérison
The Nature of Personal Reality	La nature de la réalité de la personnalité
Volume 17, Number 1, 2017 (Summer)	Volume 17, numéro 1, 2017 (été)
Urantia Spring	Printemps Urantia
A Musical Metaphor	Une métaphore musicale
The Temple Of Spiritual Brotherhood and the Greater Meaning Of Study Groups	Le temple de la fraternité spirituelle et la plus grande signification des groupes d'étude
What Will We Find in Outer Space?	Que trouverons-nous dans l’espace ?
What is Interfaith?	Qu’est-ce que l’interconfessionnel ?
The Shroud of Turin and The Urantia Papers	Le Suaire de Turin et les Cahiers d'Urantia
Questions About Being Human	Questions sur le fait d'être humain
What Does The Urantia Book Tell Us Needs to be Accomplished?	Que nous dit le Livre d’Urantia qui doit être accompli ?
Twelve Ways I Hear From God	Douze façons d’entendre Dieu
A Confederate Soldier’s Prayer	La prière d'un soldat confédéré
Volume 18, Number 1, 2018 (Summer)	Volume 18, numéro 1, 2018 (été)
Survival of the Subnormal Mind	Survie de l'esprit subnormal
The Soul Synthesis Hypothesis	L’hypothèse de la synthèse de l’âme
I, Brother - The Urantia Papers and Issues of Race	Moi, frère – Les Cahiers d'Urantia et les questions de race
A Tale of Two Men	Une histoire de deux hommes
Akhenaten	Akhénaton
The New Teacher/Leaders	Les nouveaux enseignants/dirigeants
Unsinkable and Unbreakable	Insubmersible et incassable
The Supreme Being in My Life	L'être suprême dans ma vie
The Eden-Atlantis Project	Le projet Eden-Atlantide
Volume 19, Number 1, 2019 (Summer)	Volume 19, numéro 1, 2019 (été)
Following in the Footsteps of Enoch and Elijah	Suivre les traces d’Hénoc et d’Élie : le chemin vers la fusion des ajusteurs
The Inevitable (and Necessary) ‘Organized Religion’ Based on The Urantia Book	L’inévitable (et nécessaire) « religion organisée » basée sur le Livre d’Urantia
Gems of Wisdom by Father Robert Schuer	Joyaux de sagesse
Personality Bestowal	Don de personnalité (avant et après)
Ancient Japan: Jōmon Culture	Japon ancien : culture Jōmon
Exploring Urantia Book Christology	Explorer la christologie du Livre d’Urantia
There Was a Man Once	Il était une fois un homme
Working with Mother Spirit to Uplift the World	Travailler avec l’Esprit Mère pour élever le monde
Epochal Pathways	Voies d'époque
Urantia Book - A Spiritual Path	Le Livre d'Urantia Un chemin spirituel
The Challenge of Revelation Based Education	Le défi de l’éducation basée sur la révélation
Mobilizing a Dispensation of Planetary Rehabilitation	Mobiliser une dispense de réhabilitation planétaire
Volume 20, Number 1, 2020 (Summer)	Volume 20, numéro 1, 2020 (été)
Avi Dogim, Emilio Coppola, and Steve Dreier	Emilio Coppola, Avi Dogim, Steve Dreier
From the Supreme to the Three Person’d God: Seven Levels of Total Deity	Du Dieu Suprême au Dieu à trois personnes : sept niveaux de divinité totale
Growing the Supreme	Cultiver le Suprême
Adoration of the Mother	Adoration de la Mère
TODAY is the day for JOY!	AUJOURD'HUI est le jour de la JOIE !
Uversa — the Future Headquarters of God the Supreme	Versa
To Beget Or Not to Beget That Is the Question	Engendrer ou ne pas engendrer, telle est la question : épreuve 20 contre épreuve 120
An Encounter This Unique	Une rencontre aussi unique
Contrasting Jesus and Paul	Comparer Jésus et Paul
Volume 21, Number 1, 2021 (Summer)	Volume 21, numéro 1, 2021 (été)
Cooperating with the Holy Spirit	Coopérer avec le Saint-Esprit
Mother*Mother	Mère mère
Mother and Father	Mère et père
Poem to our Parents	Poème à nos parents
Living with the Spirit of Truth	Vivre avec l'Esprit de Vérité
Song for Papa’s Family	Chanson pour la famille de papa
Of Two Minds: Human and Divine	De deux esprits : humain et divin
Thinking of my Divine Mother, aka the Holy Spirit	Je pense à ma Divine Mère, alias le Saint-Esprit
Divine Synergy	Synergie Divine
Introduce Urantia Teachings to 15,000 People a Month	Présenter les enseignements d’Urantia à 15 000 personnes par mois
Chronology of Death Resurrection Ascension of Jesus	Chronologie de la mort, de la résurrection et de l'ascension de Jésus
To Our Mother Spirit, the Holy Spirit, the Giver of Mind	À notre Mère Esprit, le Saint-Esprit, le Donateur d'Esprit
Sojourner of the Soul: Gardener of our Hearts	Séjourneur de l'âme : Jardinier de nos cœurs
Proclaim the Holiday of Holidays	Proclame la Fête des Fêtes : le 18 mai
Foxy Parents	Parents rusés
Volume 22, Number 1, 2022 (summer)	Volume 22, Numéro 1, 2022 (été)
Thy Kin-Dom Come	Ton Kin-Dom Viens
Revelation	Révélation
Another and Greater John (or Joan) the Baptist	Un autre et plus grand Jean (ou Jeanne) le Baptiste
Divine Dignity	Dignité divine
How I Found the Book	Comment j'ai trouvé le livre
Legacy_and_Inspiration	Héritage_et_Inspiration
Poem	Poème
Prayer	Prière
An Amazing Event is Coming for Urantia Book Readers	Un événement étonnant arrive pour les lecteurs du Livre d’Urantia (et peut-être pour le monde !)
Art of Universal Language: Spiritual Growth Conversations	L'art du langage universel : conversations sur la croissance spirituelle
Walls, Doors, and Windows: The Psychology of Disseminating the Teachings of the Urantia Book	Murs, portes et fenêtres : la psychologie de la diffusion des enseignements du Livre d'Urantia
Why The Urantia Corps of Truth Revealers Used Human Source Authors	Pourquoi les révélateurs du Corps Urantia des Révélateurs de Vérité ont utilisé des auteurs de source humaine
Your Answer Book	Votre livre de réponses
Progress Project	Projet d'avancement
Toward a Culture of Giving	Vers une culture du don
Volume 23, Number 1, 2023 (summer)	Volume 23, Numéro 1, 2023 (été)
Summer Study Session 2024	Session d'études d'été 2024
Letter from the Editor	Lettre de l'éditeur
Unity Not Uniformity	L'unité et non l'uniformité
Unity Principles—The Key to Dynamic Oneness	Principes d'unité : la clé de l'unité dynamique
Think Alike—Necessary or Unnecessary?	Pensez-y : nécessaire ou inutile ?
A Part and the Whole	Une partie et le tout
The Laborers are Few	Les ouvriers sont peu nombreux
Unity	Unité
A Global Ethic: Parliament of the World's Religions	Une éthique mondiale : le Parlement des religions du monde
The Spiritual Universal Siblinghood of Nebadon	La fratrie spirituelle universelle de Nébadon
Fear Not	N'ayez pas peur
Coordinated Working Harmony	Harmonie de travail coordonnée
President's Message	Message du président
Voices from Our Community	Voix de notre communauté
Unity—Harmony Within Diversity of Experience and Belief	Unité – Harmonie dans la diversité des expériences et des croyances
Unity Not Uniformity Crossword Puzzle	L'unité et non l'uniformité Mots croisés