Index of Urantia Foundation's News Online articles	Índice de las Noticias en Línea de la Fundación Urantia
Volume 1, 2007	Volumen 1, 2007
Volume 1, Issue 1, May 2007	Volumen 1, Número 1, mayo 2007
Welcome & Contact Details	Bienvenida e información de contacto
Welcome	Bienvenido
Newsworthy Items From The April 2007 Trustees Meeting	Artículos de interés periodístico de la reunión de administradores de abril de 2007
The Urantia Book In India	El libro de Urantia en la India
Urantia Foundation Staff: Jay Peregrine	Personal de la Fundación Urantia: Jay Peregrine
Volume 1, Issue 2, Sept. 2007	Volumen 1, Número 2, septiembre 2007
Welcome & Contact Details	Bienvenida e información de contacto
Even as I have loved you	Así como yo te he amado
Newsworthy Items From The August, 2007 Trustee Meeting	Artículos de interés periodístico de la reunión de administradores de agosto de 2007
Foundation Prints A Portuguese Translation	La Fundación imprime una traducción al portugués
An Educational Initiative	Una iniciativa educativa
Distribution: El Libro De Urantia	Distribución: El Libro De Urantia
A Short History Of The Owners Of Urantia Foundation's Head Office	Una breve historia de los propietarios de la sede de la Fundación Urantia
Comments On Urantia Online	Comentarios sobre Urantia Online
Trustee Emerita Patricia Mundelius Leaves Expanded Board	La fideicomisaria emérita Patricia Mundelius deja la junta ampliada
Reflections	Reflexiones
Help Wanted	Se busca ayuda
Volume 1, Issue 3, Dec. 2007	Volumen 1, número 3, diciembre 2007
Welcome & Contact Details	Bienvenida e información de contacto
Tension — the Prerequisite of Growth	La tensión: la condición previa del crecimiento
Urantia Foundation Launches Matching Fundraising Campaign In December, 2007	La Fundación Urantia lanza una campaña de recaudación de fondos de contrapartida en diciembre de 2007
Newsworthy Decisions From Urantia Foundation's October Trustees Meeting	Decisiones de interés periodístico de la reunión de octubre de los fideicomisarios de la Fundación Urantia
German Translation Brings Readers Together	La traducción al alemán une a los lectores
Neal Waldrop Concludes Four Years of Active Participation	Neal Waldrop concluye cuatro años de participación activa
Millennial Reflections	Reflexiones Del Milenio
Seeding the Revelation in South Africa	Sembrando la Revelación en Sudáfrica
Volume 2, 2008	Volumen 2, 2008
Volume 2, Issue 1, March 2008	Volumen 2, Número 1, marzo 2008
Welcome & Contact Details	Bienvenida e información de contacto
The Secret of a Better Civilisation	El secreto de una civilización mejor
O Livro de Urântia Premiered in Brazil	O Livro de Urântia presentado en Brasil
Newsworthy Decisions From Urantia Foundation's January 2008 Trustees Meeting	Decisiones destacadas de la reunión de los fideicomisarios de la Fundación Urantia de enero de 2008
Japanese Translation Continues To Progress	Avance de la traducción japonesa
In Memorium: Karlheinz Stockhausen	El famoso compositor (y lector del Libro de Urantia) Karlheinz Stockhausen ha fallecido
Study Groups: The Principle Of Sharing	Grupos de estudio: el principio de compartir
Reflections on introducing The Urantia Book	Reflexiones acerca de cómo introducir El Libro de Urantia
Testimonials About The Urantia Book	Testimonios Sobre El libro de Urantia
Two new Trustees elected	Elegidas dos nuevas fideicomisarias
Volume 2, Issue 2, June 2008	Volumen 2, Número 2, junio 2008
Welcome & Contact Details	Bienvenida e información de contacto
The Revelation Enters the 21st Century	La Revelación entra en el siglo XXI
Noteworthy Decisions From The April 2008 Board Meeting In Paris	Decisiones destacadas de la reunión de abril de la Junta en París
Buenos Aires Book Fair	La Feria del Libro de Buenos Aires
The Urantia Community Endowment: A Fund For The Future	El Fondo de Dotación de la Comunidad Urantia: un fondo para el futuro
Duane Faw: Honoring a Man Who Served the Revelation	Duane Faw: Homenaje a un hombre que sirvió a la Revelación
Volume 2, Issue 3, Sept. 2008	Volumen 2, Número 3, septiembre 2008
Welcome & Contact Details	Bienvenida e información de contacto
Seppo Kanerva announces his Retirement	Seppo Kanerva anuncia su retiro
The Future of the Urantia Movement	El futuro del movimiento Urantia
Newsworthy Decisions Made By Urantia Foundation's Board Of Trustees	Decisiones Destacadas De La Junta De Fideicomisarios De La Fundación Urantia - 2008
Printing Of El Libro De Urantia European Edition	Impresión de la edición europea del Libro de Urantia
A Tribute to Pat Mundelius	Homenaje a Pat Mundelius
Why Is The Urantia Book Religious But Not a Religion?	¿Por qué El Libro De Urantia es religioso pero no es una religión?
Are You a New Religion or a Cult?	¿Sois una nueva religión o una secta?
UBIS... Celebrating 10 Years of Dedicated Service To The Urantia Book Community	UBIS: Celebración de los 10 años de servicio dedicado a la comunidad del Libro de Urantia
Volume 2, Issue 4, Dec. 2008	Volumen 2, Número 4, diciembre 2008
Welcome & Contact Details	Bienvenida e información de contacto
Holiday Greetings From Urantia Foundation	Felices Fiestas De La Fundación Urantia
Urantia Foundation Launches Matching Fund-Raising Campaign 2008	La Fundación Urantia Lanza La Campaña De Recaudación De Fondos De 2008
Noteworthy Decisions From The November 2008 Board Meeting	Decisiones Noviembre 2008
The Urantia Book In Austria	El Libro De Urantia En Austria
Education And Urantia Foundation	La educación y la Fundación Urantia
Second Meeting of Urantia Book Readers In Germany	Segundo Encuentro De Lectores De El libro de Urantia En Alemania
Henk Mylanus, New Associate Trustee And European Manager Of Sales	Henk Mylanus, nuevo fideicomisario asociado y Director de Ventas en Europa
Reflections	Reflexiones
Volume 3, 2009	Volumen 3, 2009
Volume 3, Issue 1, March 2009	Volumen 3, Número 1, marzo 2009
Welcome & Contact Details	Bienvenida e información de contacto
Kind and Generous Souls	Almas generosas y amables
Noteworthy Decisions From The January 2009 Board Meeting	Decisiones Tomadas En La Reunión De Enero De La Junta - 2009
A Vision of the Future	Una Visión Del Futuro
The History of the Polish Translation	Historia De La Traducción Polaca
Standard Reference Text Commiffee Report	Informe Del Comité Del Texto De Referencia Estándar
Millennial Reflections	Reflexiones Del Milenio
The Urantia Book Index Project	El Proyecto Índice De The Urantia Book
UBIS is Hot!	¡La UBIS Está Viva!
Holiday Party At 533 Diversersey	Fiesta En El 533 De Diversey
Volume 3, Issue 2, June 2009	Volumen 3, Número 2, junio 2009
Welcome & Contact Details	Bienvenida e información de contacto
Gratitude To Those Who Serve The Revelation	Gratitud Hacia Los Que Sirven A La Revelación
Pre-Conference Leadership Roundtable	Mesa Redonda De Líderes En La Pre-Conferencia
Noteworthy Decisions From The April 2009 Board Meeting	Decisiones Tomadas En La Reunión De Abril De La Junta - 2009
God Consciousness — A Living University	La Conciencia De Dios – Una Universidad Viviente
Update From The Urantia Book Internet School (UBIS)	Novedades de la Escuela en Internet de El libro de Urantia (UBIS)
Looking For A French Distributor	Buscando Distribuidor en Francia
The Urantia Book And Christianity	El libro de Urantia y el Cristianismo
Printing of El Libro De Urantia European Edition	Impresión De La Edición Europea De El libro de Urantia
The Second Mile As A Community Experience	La Segunda Milla Como Una Experiencia De Comunidad
Reflections — Where Gaps Were Bridged	Reflexiones – Donde Se Tendieron Puentes
Volume 3, Issue 3, Sept. 2009	Volumen 3, número 3, septiembre 2009
Welcome & Contact Details	Bienvenida e información de contacto
The Road Ahead	El Camino Que Nos Espera
Parliament of the World's Religions 2009	Parlamento De Las Religiones Del Mundo 2009
Noteworthy Decisions from the July 2009 Board Meeting	Decisiones Tomadas En La Reunión De Julio De La Junta - 2009
The History of the Hungarian (Magyar) Translation	La Historia De La Traducción Húngara (Magiar)
Interest in the Chinese Translation	Interés Por La Traducción China
The Second Mile In Retrospect: Thoughts On The Boulder Experiment	La Segunda Milla En Retrospectiva: Reflexiones Acerca Del Experimento De Boulder
Reflections on 533 Diversey	Reflexiones Sobre 533 Diversey
El Libro De Urantia — European Edition	El Libro De Urantia – Edición Europea
Quebec Office Closed	Cierre De La Oficina De Quebec
God Consciousness: A Living University Inspires In-Depth Study	La Conciencia De Dios: Una Universidad Viva Inspira El Estudio En Profundidad
A Poem for Bert Cobb	Poema Para Bert Cobb
Volume 3, Issue 4, Dec. 2009	Volumen 3, Número 4, diciembre 2009
Welcome & Contact Details	Bienvenida e información de contacto
Urantia Foundation Launches Matching Fund-Raising Campaign 2009	La Fundación Urantia Lanza La Campaña 2009 De Recaudación De Fondos
Jesus and Ganid	Jesús y Ganid
Noteworthy Decisions From The October 2009 Board Meeting	Decisiones Tomadas En La Reunión De Octubre De La Junta - 2009
Library Placement	Colocación en Bibliotecas
When Great Britain Meets Little Brittany	Cuando Gran Bretaña se Encuentra con la Pequeña Bretaña
The Pipeline of Light	El Tubo De Luz
The French Audio Version of Le Livre d'Urantia	La Versión Audio De Le Livre D’urantia
Das Urantia Buch in Munich	Das Urantia Buch en Múnich
Meeting of the IT Minds	Reunión De Cerebros IT
Volume 4, 2010	Volumen 4, 2010
Volume 4, Issue 1, March 2010	Volumen 4, Número 1, marzo 2010
Welcome & Contact Details	Bienvenida e información de contacto
Reflections on 2009 and a Look into the Future	Reflexiones sobre 2009 y una mirada hacia el futuro
Sweden and The Urantia Book	Suecia y El Libro de Urantia
Parliament of The World's Religions	Parlamento de las Religiones del Mundo
Unexpected Joy	Alegría inesperada
A Gathering In Mexico City	Encuentro en Ciudad de México
Our Trip To Mexico City	Nuestro viaje a Ciudad de México
Orlando Florida: Another Chapter Unfolds	Orlando (Florida): otro capítulo comienza
Volume 4, Issue 2, June 2010	Volumen 4, Número 2, junio 2010
Welcome & Contact Details	Bienvenida e información de contacto
1,000 Libraries, 1,000 Book Reviews, and 1,000 Study Groups	1000 bibliotecas, 1000 reseñas y 1000 grupos de estudio
Noteworthy Decisions from the April 2010 Board Meeting	Decisiones destacadas de la reunión de la junta directiva de abril de 2010
UBIS News: A New Website, an Expanded Curriculum, and the Challenge Ahead	Noticias de la UBIS: nueva web, plan de estudio ampliado y retos futuros
Introducing the Urantia Book Historical Society	Presentación de la Sociedad Histórica de El libro de Urantia
Attending the Book Fair in Budapest, Hungary	Asistencia a la Feria del Libro de Budapest (Hungría)
9th National Meeting Of Readers In Spain — Cultivating Universal Intelligence	IX Encuentro de Lectores en España: Cultivar la inteligencia universal
Nola Smith: A Pioneer in Launching the Urantia Revelation	Nola Smith: una pionera en dar a conocer la Revelación Urantia
Volume 4, Issue 3, Sept. 2010	Volumen 4, Número 3, septiembre 2010
Welcome & Contact Details	Bienvenida e información de contacto
President's Report	Informe del Presidente
Noteworthy Decisions from the July 2010 Board Meeting	Decisiones destacadas de la 3 reunión de julio de la Junta
Dorothy Elder Passes the UBIS Leadership Torch	Dorothy Elder pasa el testigo de la dirección de la UBIS
Appreciative Inquiry for Study Groups	Indagación apreciativa para los grupos de estudio
Study Groups: New Thoughts from an Old Reader	Grupos de estudio: nuevos pensamientos de un lector veterano
A Follow Up to Placing Urantia Books in Alternative Libraries	Seguimiento de la colocación de Libros de Urantia en bibliotecas alternativas
Comments from Readers of The Urantia Book	Comentarios de lectores de El libro de Urantia
Volume 4, Issue 4, Dec. 2010	volumen 4, número 4, diciembre 2010
Welcome & Contact Details	Bienvenida e información de contacto
The Art of Translations	El arte de traducir
Receiving Az Urantia könyv, the Magyar (Hungarian) Translation of The Urantia Book	Recepción de Az Urantia könyv, la traducción bingara de El libro de Urantia
El Libro De Urantia Edición Europea — The Spanish European Edition	El libro de Urantia — Edición europea, la edición en español de España
Urantiaboken — the Swedish Translation	Urantiaboken, la traducción sueca
O Livro de Urântia — the Portuguese Translation	O Livro de Urântia, la traducción portuguesa
Księga Urantii: The Polish Translation Has Reached the Readers	Księga Urantii: la traducción polaca ha llegado a los lectores
Das Urantia Buch — the German Translation	Das Urantia Buch, la traducción alemana
The Story Of Urantia Raamat — The Estonian Translation	La historia de Urantia Raamat — La traducción estonia
Книга Урантии — the Russian Translation	Книга Урантии, la traducción rusa
“Go Into All the World” — Jesus	«Id por todo el mundo» (Jesús)
Volume 5, 2011	Volumen 5, 2011
Volume 5, Issue 1, March 2011	Volumen 5, Número 1, marzo 2011
Welcome & Contact Details	Bienvenida e información de contacto
The Age of Wonder	La Era de las Maravillas
Noteworthy Decisions from the January 2011 Board of Trustees Meeting	Decisiones Destacadas De La Reunión De Enero De La Junta - 2011
The Education Initiative	La Iniciativa de Educación
A Short History of the French Translation	Breve historia de la traducción francesa
Second Society Foundation and A Study of the Master Universe	La Second Society Foundation y «Estudio del universo maestro»
The Trustees Meet in the Lone Star State	Los fideicomisarios se reúnen en el Estado de la Estrella
Comments from Readers of The Urantia Book	Comentarios de lectores de El libro de Urantia
Volume 5, Issue 2, June 2011	Volumen 5, Número 2, junio 2011
Welcome & Contact Details	Bienvenida e información de contacto
Why Study Groups Matter to the Future of the World	Por qué los grupos de estudio son importantes para el futuro del mundo
Noteworthy Goals from the April 2011 Board of Trustees Meeting	Decisiones destacadas de la reunión de abril de la Junta
Jay Peregrine visits Finland	Jay Peregrine visita Finlandia
The Spanish Revision Project	El proyecto de revisión de la traducción española
The Urantia Book Internet School — My Lifeline to the Urantia Book Community	La Escuela de El libro de Urantia en Internet - Mi trayectoria en la comunidad de El libro de Urantia
The Debut of The Urantia Book at the 2011 Budapest Book Fair	El debut de El libro de Urantia en la Feria del Libro de Budapest 2011
Comments from Readers of The Urantia Book	Comentarios de lectores de El libro de Urantia
Volume 5, Issue 3, Sept. 2011	Volumen 5, número 3, septiembre 2011
Welcome & Contact Details	Bienvenida e información de contacto
Report on the Kickoff Meeting for the Revision of the Spanish Translation	Informe de la reunión de inicio de la revisión de la traducción española
Noteworthy Goals and Decisions from the July 2011 Board of Trustees Meeting	Decisiones y metas destacadas de la reunión de julio de la Junta
Urantia Book Readers Study Together this Summer	Los lectores de El libro de Urantia estudian juntos este verano
Training Teachers/Facilitators for the Urantia Book Internet School	Formación de profesores y facilitadores para la Escuela de El libro de Urantia en Internet
Planned Giving to Urantia Foundation	Donación planeada a la Fundación Urantia
Report from the Pipeline of Light 2003-2011	Informe del «Canal de luz» 2003-2011
A Reader's Experience Staying at 533 W Diversey Parkway	Experiencia de un lector que visitó el 533 de Diversey Parkway
Comments from Readers	Comentarios de los lectores
Volume 5, Issue 4, Dec. 2011	Volumen 5, Número 4, diciembre 2011
Welcome & Contact Details	Bienvenida e información de contacto
A Season of Gratitude and a Time for Generosity	Época de gratitud y momento de generosidad
Noteworthy Decisions from the October 2011 Board of Trustees Meeting	Decisiones destacadas de la reunión de octubre de la Junta de Fideicomisarios
Fast Start for Urantia Book Study Group Portal — Tri-Partisan Support Team Formed	Inicio rápido del Portal de Grupos de Estudio de El libro de Urantia
The Rewards of Being a Teacher/Facilitator for UBIS	Las recompensas de ser profesor/facilitador de la UBIS
Report on the Kickooff Meeting for the Revision of the Portuguese Translation	Informe de la reunión de lanzamiento de la revisión de la traducción portuguesa
Das Urantia Buch Presented at the Book Fair in Rasatt, Germany	Das Urantia Buch se presentó en la Feria del Libro de Rasatt (Alemania)
The Siegels Visit Sweden, Estonia, Russia, and Finland in June, 2011	Los Siegel visitan Suecia, Estonia, Rusia y Finlandia en junio
Centering Prayer Retreat in Brittany, France	Retiro de oración contemplativa en la Bretaña francesa
A New Associate Trustee Is Appointed	Nombramiento de un nuevo fideicomisario asociado
Comments from Readers	Comentarios de los lectores
Volume 6, 2012	Volumen 6, 2012
Volume 6, Issue 1, March 2012	Volumen 6, Número 1, marzo 2012
Welcome & Contact Details	Bienvenida e información de contacto
Our Journey to South America	Nuestro viaje a Sudamérica
Noteworthy Decisions from the January 2012 Board of Trustees Meeting	Decisiones destacadas de la reunión de la Junta de Fideicomisarios de enero de 2012
Teacher-Facilifators Needed for the Urantia Book Internet School	Se necesitan profesores-facilitadores para la Escuela de El libro de Urantia en Internet
The Urantia Book around the world	El Libro de Urantia por el mundo
Comments from Readers of The Urantia Book	Comentarios de los lectores
Volume 6, Issue 2, June 2012	Volumen 6, Número 2, junio 2012
Welcome & Contact Details	Bienvenida e información de contacto
Worship and Wisdom at 533 W Diversey Parkway	Adoración y sabiduría en el 533 w Diversey Parkway
Noteworthy Decisions from the April 2012 Board of Trustees Meeting	Decisiones destacadas de la reunión de la junta de fideicomisarios de Abril de 2012
The Hebrew Translation of The Urantia Book	La traducción al Hebreo de El libro de Urantia
Reflections on the 11th meeting of Urantia Book readers in Spain	Reflexiones sobre el XI Encuentro de Lectores de El libro de Urantia en España
A Meredith Sprunger Story	Una historia de Meredith Sprunger
How I found The Urantia Book	Cómo encontré El libro de Urantia
Help Wanted for Translations	Se necesita ayuda
My trip to Colombia, South America	Mi viaje a Colombia (Sudamérica)
Urantia Book Study Group Directory	El directorio de grupos de estudio de El libro de Urantia
Two New Appointments	Dos nuevos nombramientos
Reader Comments	Comentarios de los lectores
Irmeli Ivalo-Sjölie: Book Ambassador at Large	Irmeli Ivalo-Sjölie: Embajadora del libro a distancia
Volume 6, Issue 3, Aug. 2012	Volumen 6, Número 3, agosto 2012
Welcome & Contact Details	Bienvenida e información de contacto
Pulling Together for the Common Good	Remando juntos por el bien común
Noteworthy Decisions from the July 2012 Board of Trustees Meeting	Decisiones destacadas de la reunión de la junta de fideicomisarios de julio de 2012
The Urantia Book and its teachings in Babasa Indonesia	El Libro de Urantia y sus enseñanzas en Indonesio
Spanish UBIS—One More Step in the Expansion of the Urantia Book Internet School	La UBIS en español - un paso más en la expansión de la escuela de El Libro de Urantia en internet
The Evolution of Translations	La evolución de las traducciones
A Timeline for The Urantia Book	Cronología de El Libro de Urantia y sus traducciones
Five Days at 533 W Diversey Parkway	Cinco días en el 533 de W Diversey Parkway
A Summer Urantia Book Conference in Berlin	Conferencia de verano de El Libro de Urantia en Berlín
Remembering Mary Lou Hales	En recuerdo de Mary Lou Hales
Remembering Werner Sutter	En recuerdo de Werner Sutter
Volunteers Needed	Se necesitan voluntarios
Comments from readers	Comentarios de lectores
Volume 6, Issue 4, Nov. 2012	Volumen 6, Número 4, noviembre 2012
Welcome & Contact Details	Bienvenida e información de contacto
Joint Meeting of The Urantia Book Fellowship and Urantia Foundation	Reunión conjunta de la Urantia Book Fellowship y la Fundación Urantia
Winter Fundraising Match of $160,000 Launches Now	Comienza la igualación de fondos de invierno de 160.000$
An Audio Version of The Urantia Book in Portuguese	Versión en audio de El libro de Urantia en Portugués
Engineering the Audio O Livro de Urântia	Ser el ingeniero de sonido de O Livro de Urântia
Noteworthy Decisions from the October 2012 Board of Trustees Meeting	Decisiones destacadas de la reunión de octubre de los fideicomisarios
A Community Introduction to The Urantia Book	Una introducción de El libro de Urantia en la comunidad
A Seminar on the Truths of Spiritual Experience	Seminario sobre las verdades de la experiencia espiritual
The Number of Urantia Books Printed between 1955 and 2012	El número de Libros de Urantia impresos entre 1955 y 2012
The Third Urantia Book Information Technology (IT) Roundtable	Tercera Mesa Redonda de las Tecnologías de la Información (TI) y El libro de Urantia
Impressions of the Information Technology Roundtable	Impresiones sobre la Mesa Redonda de Tecnologías de la Información
Reader Comments	Comentarios de los lectores
Urantia Book Holiday Sale	Venta navideña de El libro de Urantia
Volume 7, 2013	Volumen 7, 2013
Volume 7, Issue 1, March 2013	Volumen 7, Número 1, marzo 2013
Welcome & Contact Details	Bienvenida e información de contacto
Urantia Foundation Announces New Book Covers For The Urantia Book	Nuevas portadas para El libro de Urantia
Noteworthy Decisions from the January 2013 Board of Trustees Meeting	Decisiones destacadas de la reunión de enero de la Junta de Fideicomisarios
The 2012 Survey of Readers of The Urantia Book	La encuesta 2012 de lectores de El libro de Urantia
Finding a Distributor in Hungary for the Hungarian translation, Az Urantia könyv	Búsqueda de un distribuidor en Hungría para la traducción al búngaro, Az Urantia könyv
Around the World with Urantia Book. Ambassador Irmeli Ivalo-Sjölie	Por el mundo con la embajadora de El libro de Urantia, Irmeli Ivalo-Sjölie
How the Idea for a Urantia Book Translation Tool was Born	Cómo surgió la idea de una herramienta para traducciones de El libro de Urantia
A Group Meditation at Urantia Foundation	Meditación en grupo en la Fundación Urantia
Half Price Books-an Opportunity for Urantia Book Dissemination	Libros a mitad de precio - una oportunidad para la diseminación de El libro de Urantia
A Thank You Note from Chile	Nota de agradecimiento desde Chile
A Reader's Comment	Comentarios de un lector
Announcements	Anuncios
Volume 7, Issue 2, June 2013	Volumen 7, número 2, junio 2013
Welcome & Contact Details	Bienvenida e información de contacto
New Planned Giving Website at Urantia.org	Nueva web de donación planificada en urantia.org
Notewortby Decisions from the April 2013 Board of Trustees Meeting	Decisiones destacadas de la reunión de abril 2013
A Decimal Seminar	Seminario decimal
The Urantia Book in Spain	El libro de Urantia en España
Translating The Urantia Book Into Farsi: The Inspiring Story Of How This Project Began	Traducir El libro de Urantia al parsi: La historia inspiradora de cómo comenzó este proyecto
Inspire and Be Inspired	Inspira y sé inspirado
The Third Meeting of the Blue Club in Frankfurt, Germany	La tercera reunión del Blue Club en Frankfurt (Alemania)
A New Platform for The Urantia Book Internet School	Nueva plataforma para la Escuela 10 de El libro de Urantia en Internet (UBIS)
A Reader's Comment	Comentarios de una lectora
Volume 7, Issue 3, Sept. 2013	Volumen 7, número 3, septiembre 2013
Welcome & Contact Details	Bienvenida e información de contacto
Smart Religion	Religión inteligente
Noteworthy Decisions from the July 2013 Board of Trustees Meeting	Decisiones destacadas de la reunión de julio 2013
What the Women are Planning	¿Qué se encuentran planificando las mujeres?
The Urantia Book Study Group Directory	El Directorio de grupos de estudio de El libro de Urantia
One Student's Perspective on UBIS	La opinión de una alumna de la UBIS
A Tale of Two Conferences	Relato de dos conferencias
Urantia Book. Ambassador Irmeli Ivalo-Sjölie visits Finland, and the USA	La embajadora de El libro de Urantia, Irmeli Ivalo-Sjölie, visita Finlandia y los EEUU
The Urantia Book in Korea	El libro de Urantia en Corea
A Reader's Comment	Comentarios de una lectora
Help Wanted	Se necesita ayuda
Volume 7, Issue 4, Dec. 2013	Volumen 7, Número 4, diciembre 2013
Welcome & Contact Details	Bienvenida e información de contacto
Matthew the Money-getter	Mateo, el que consigue el dinero
Noteworthy Decisions from the October 2013 Board of Trustees Meeting	Decisiones destacadas de la reunión de octubre de la Junta de Fideicomisarios
Urantia Books En Route to the Philippines	Libros de Urantia de camino a Filipinas
A Filmmaker's Approach to Promoting The Urantia Book	Enfoque de un cineasta para promocionar El libro de Urantia
The Urantia Book Study Group Directory	El Directorio de Grupos de Estudio de El libro de Urantia
Holiday Party at Urantia Foundation	Celebración navideña en la Fundación Urantia
Adventures in Placing The Urantia Book	La aventura de colocar El libro de Urantia
Growing Old Gracefully	Envejecer con dignidad
Job Opening At Urantia Foundation	Anuncio para el puesto de director ejecutivo
A Reader's Comment	Comentarios de una lectora
Volume 8, 2014	Volumen 8, 2014
Volume 8, Issue 1, March 2014	Volumen 8, Número 1, marzo 2014
Welcome & Contact Details	Bienvenida e información de contacto
A Survey of Translators and Revisers of The Urantia Book	Encuesta sobre traductores y revisores de El libro de Urantia
Noteworthy Decisions from the January 2014 Board of Trustees Meeting	Decisiones destacadas de la reunión de enero de la Junta de Fideicomisarios
The Urantia Book in the Philippines: an Outreach Project Update	El libro de Urantia en Filipinas: novedades del proyecto de asistencia
Restoring the Birthplace of the Fifth Epochal Revelation	La restauración del lugar de nacimiento de la Quinta Revelación de Época
Churchification	Iglesificación
The Study Group Symposium	El Simposio de Grupos de Estudio
Preparing For My First International Conference	La preparación de mi primera conferencia internacional
What the Women Are Planning: a Report from our Second Gathering	Lo que están planeando las mujeres: informe de nuestro segundo encuentro
A Reader's Comment	Comentarios de una lectora
Volume 8, Issue 2, July 2014	Volumen 8, Número 2, julio 2014
Welcome & Contact Details	Bienvenida e información de contacto
Behind the Scenes of the Hebrew Translation Project	El proyecto de traducción al hebreo entre bastidores
Noteworthy Decisions from the April 2014 Board of Trustees Meeting	Decisiones destacadas de la reunión de abril de la Junta de Fideicomisarios
The Urantia Book: A Blessing for Ukraine	El libro de Urantia: una bendición para Ucrania
The International Book Fair in Bogotá, Colombia	La Feria Internacional del Libro de Bogotá (Colombia)
Second In-depth Revision of the French Translation	Segunda revisión en profundidad de la traducción al francés
The Urantia Book Study Group Directory	El Directorio de Grupos de Estudio de El Libro de Urantia
Journal of a Journey: Seeding Urantia Books in the Caribbean	Diario de un viaje: la siembra de Libros de Urantia en el Caribe
The Urantia Book in the Philippines	El libro de Urantia en Filipinas
A Workshop on the Soul	Taller sobre el alma
Trip to the Holy Land	Viaje a Tierra Santa
Volume 8, Issue 3, Sept. 2014	Volumen 8, Número 3, septiembre 2014
Welcome & Contact Details	Bienvenida e información de contacto
Happenings in Indonesia	Acontecimientos de Indonesia
Noteworthy Decisions from the July 2014 Board of Trustees Meeting	Decisiones destacadas de la reunión de julio de la Junta de Fideicomisarios
The Urantia Book in Guatemala	El libro de Urantia en Guatemala
Joint Seminar of the Education Committees of Three Major Urantia Organizations	Seminario conjunto del Comité de Educación de las tres principales organizaciones Urantia
International Conference 2014: A Personal Experience	Conferencia internacional 2014: una experiencia personal
A Dream Come True: Experiencing Urantia Foundation and the Study Group Symposium	Un sueño hecho realidad: experimentar la Fundación Urantia y el Simposio de Grupos de Estudio
The Study Group Symposium: Report on the Speeches	El Simposio de Grupos de Estudio: informe sobre las charlas
The Beauty of Sharing: Seeding the teachings in Indonesia	La belleza de compartir: la siembra de la enseñanzas en Indonesio
Finding The Urantia Book in Nigeria: an Answer to my Childhood Prayer	Encontrar El libro de Urantia en Nigeria: la respuesta a las oraciones de mi niñez
Announcements	Anuncios
Volume 8, Issue 4, Dec. 2014	Volumen 8, Número 4, diciembre 2014
Welcome & Contact Details	Bienvenida e información de contacto
Urantia Foundation's Year-End Fundraising Match	Igualación de fondos de final de año de la Fundación Urantia
Noteworthy Decisions from the October 2014 Board of Trustees Meeting	Decisiones destacadas de la reunión de octubre de la Junta de Fideicomisarios
Urantia, Nebadon, and the Master Universe: A New Film on Perspectipe	Urantia, Nebadon y el Univeso maestro: nueva película en perspectiva
An Update from the Education Committee	Novedades del Comité de Educación
A Beach Retreat: What Prayer Was to Jesus	Retiro en la playa: lo que la oración era para Jesús
Reflections from The Women's Retreat	Reflexiones del Retiro de Mujeres
Comments from the Soul Workshop	Comentarios del taller sobre el Alma
What The Urantia Book Means to Me	Lo que El libro de Urantia significa para mí
Urantia Book Holiday Sale	Campaña navideña de El Libro de Urantia
Volume 9, 2015	Volumen 9, 2015
Volume 9, Issue 1, March 2015	Volumen 9, Número 1, marzo 2015
Welcome & Contact Details	Bienvenida e información de contacto
A Urantia Book Booth at the Parliament of the Worlds Religions	Un stand de El libro de Urantia en el Parlamento de las Religiones del Mundo
Foundation Highlights of 2014	Lo más destacado de la Fundación en 2014
Noteworthy Decisions from the January 2015 Board of Trustees Meeting	Decisiones destacadas de de la reunión de enero de la Junta de Fideicomisarios
The 2015 Intemational Book Fair in Jerusalem	La Feria Internacional del Libro 2015 de Jerusalén
Disseminating The Urantia Book in Ukraine	La diseminación de El libro de Urantia en Ucrania
What The Urantia Book Means to Me?	¿Qué significa El libro de Urantia para mi?
Urantia Book Outreach in the Philippines	Alcance de El libro de Urantia en Filipinas
How Discovering The Urantia Book Has Affected My Life	Cómo ha afectado a mi vida el descubrimiento de El libro de Urantia
Announcements	Anuncios
Volume 9, Issue 2, June 2015	Volumen 9, Número 2, junio 2015
Welcome & Contact Details	Bienvenida e información de contacto
The Italian Translation of The Urantia Book	La traducción al italiano de El libro de Urantia
Noteworthy Decisions from the April 2015 Board of Trustees Meeting	Decisiones destacadas de la reunión de abril de la Junta de Fideicomisarios
My Reflections after the Book Expo America	Mis reflexiones sobre la BookExpo America
The Bogotá International Book Fair	La Feria Internacional del Libro de Bogotá
A Cooperative Venture at the Chicago Lit Fest	Una empresa cooperativa en el Chicago Lit Fest
The Foundation's Photo Gallery: Preserving History	La galería de fotos de la Fundación: preservar la historia
What The Urantia Book Means to Me	Lo que El libro de Urantia significa para mí
My Quest to Find Answers	Mi búsqueda de respuestas
Annoucements	Anuncios
Volume 9, Issue 3, Sept. 2015	Volumen 9, número 3, septiembre 2015
Welcome & Contact Details	Bienvenida e información de contacto
A Gathering of Readers in Italy	Encuentro de lectores en Italia
Noteworthy Decisions from the July 2015 Board of Trustees Meeting	Decisiones destacadas de la reunión de julio de la junta de fideicomisarios
The Highest Joy	La alegría más grande
Remembering Luiz Carlos Dolabela Chagas	En recuerdo de Luiz Carlos Dolabella Chagas
The Worship Experience at SSS15	La experiencia de adoración en la SSS15
Looking Back at the UAI 2015 Québec Conference	Retrospectiva de la Conferencia de la AUI 2015 en Quebéc
October 12, 1955	12 de octubre de 1955
Thoughts and Reflections on What The Urantia Book Means to me	Pensamientos y reflexiones sobre lo que significa El libro de Urantia para mi
Volume 9, Issue 4, Dec. 2015	Volumen 9, Número 4, diciembre 2015
Welcome & Contact Details	Bienvenida e información de contacto
Urantia Foundation's Year-End Fundraising Match	Campaña de igualación de fondos de fin de año de la Fundación Urantia
Noteworthy Decisions from the October 2015 Board of Trustees Meeting	Decisiones destacadas de la reunión de octubre de la Junta de Fideicomisarios
The Urantia Book at the Parliament of the World's Religions	El libro de Urantia en el Parlamento de las Religiones del Mundo
Money Matters Matter	Los asuntos de dinero importan
The Work of the Urantia Book Internet School (UBIS)	El trabajo de la Escuela de El libro de Urantia en Internet (UBIS)
Living a Compassionate Life—A Urantia Foundation Workshop	Vivir la vida con compasión: taller de la Fundación Urantia
Dancing with God: Weaving the Tapestry of the Supreme	Bailar con Dios: tejer el tapiz del Supremo
A Urantia Book Youth Turns Forty	Un joven de El Libro de Urantia llega a los cuarenta
Volume 10, 2016	Volumen 10, 2016
Volume 10, Issue 1, March 2016	Volumen 10, Número 1, marzo 2016
Welcome & Contact Details	Bienvenida e información de contacto
The Urantia Book in Cameroon: Reflections from a Study Group Leader	El libro de Urantia en Camerún: reflexiones de un lider de grupo de estudio
Noteworthy Decisions from the January 2016 Board of Trustees Meeting	Decisiones destacadas de la reunión de enero de la Junta de Fideicomisarios
Science Symposium 2016	Simposio de Ciencia 2016
UBIS: A student's Perspective	La UBIS desde el punto de vista de un alumno
2016 Joint Conference—Time Dwindles and Planning Intensifies	Conferencia conjunta de 2016 - El tiempo se reduce y la planificación se intensifica
The Women 's Assembly— an Uplifting Experience	La Asamblea de Mujeres - una experiencia inspiradora
Registration Starts Soon for The Urantia Book Internet School April Trimester	La inscripción para los cursos de abril de la Escuela de El libro de Urantia en Internet comenzará pronto
How The Urantia Book Inspires Giving	Cómo El libro de Urantia nos inspira a dar
Volume 10, Issue 2, June 2016	Volumen 10, número 2, junio 2016
Welcome & Contact Details	Bienvenida e información de contacto
Remaining Relevant: Urantia Fundation Announces Urantia Press	Seguir siendo relevantes: la Fundación Urantia anuncia Urantia Press
Noteworthy Decisions from the March 2016 Board of Trustees Meeting	Decisiones destacadas de la reunión de marzo de la Junta de Fideicomisarios - 2016
The Revision of the Portuguese Translation of The Urantia Book	La revisión de la traducción al portugués de El libro de Urantia
Reflections on the 2016 Science Symposium	Reflexiones sobre el Simposio de Ciencia 2016
The Summer Conference in San Antonio	La Conferencia de Verano de San Antonio
The 2016 Bogotá International Book Fair	La Feria Internacional del Libro de Bogotá 2016
CosmicCreations—An Outreach Effort	CosmicCreations - un esfuerzo de asistencia
What Did, Does, and Will The Urantia Book Mean To?	¿Qué ha significado, significa y significará El libro de Urantia para mí?
Volume 10, Issue 3, Sept. 2016	Volumen 10, número 3, septiembre 2016
Welcome & Contact Details	Bienvenida e información de contacto
A Report on Translations of The Urantia Book	Informe sobre las traducciones de El libro de Urantia
Noteworthy Decisions from the July 2016 Board of Trustees Meeting	Decisiones destacadas de la reunión de julio de la Junta de Fideicomisarios - 2016
Volume 10, Issue 4, Dec. 2016	Volumen 10, número 4, diciembre 2016
Welcome & Contact Details	Bienvenida e información de contacto
Stewardship	Administración
Noteworthy Decisions from the October 2016 Board of Trustees Meeting	Decisiones destacadas de la reunión de octubre de la Junta de Fideicomisarios - 2016
A New Library of Human Source Books	Nueva biblioteca de libros de fuentes humanas
The First Conference for Readers of The Urantia Book in Russia	La primera Conferencia de Lectores de El libro de Urantia en Rusia
2016 European Urantia Conference in Budapest—Who is Jesus?	La Conferencia Urantia Europea de Budapest - ¿Quién es Jesús?
The Latin American Conference—The Teacher and the Student	La Conferencia Latinoamericana – El Maestro y el Discípulo
Dancing with God: Embodying the Love of God	Bailar con Dios: personificar el Amor de Dios
Cathy Jones, “Our Cathy”	Cathy Jones – «Nuestra Cathy»
Circles of Trust: An Experience in Soul Sharing	Círculos de Confianza: una experiencia de compartir entre almas
The World's Best Stories	Las mejores historias del mundo
Volume 11, 2017	Volumen 11, 2017
Volume 11, Issue 1, March 2017	Volumen 11, Número 1, marzo 2017
Welcome & Contact Details	Bienvenida e información de contacto
Joint Education Seminar at Urantia Foundation Focuses on Sharing the Teachings	Seminario conjunto de Educación en la Fundación Urantia sobre cómo compartir las enseñanzas
Noteworthy Decisions from the January 2017 Board of Trustees Meeting	Decisiones destacadas de la reunión de enero de la Junta de Fideicomisarios - 2017
The Polish Translation After Six Years	La traducción al polaco, seis años después
Report from the Finnish Office	Informe de la oficina finlandesa
Mission Accomplished—A Urantia Conference in Ghana	Misión cumplida: conferencia Urantia en Ghana
My Experience As a Urantia Book Internet School Facilitator	Mi experiencia como facilitadora en la Escuela de El libro de Urantia en Internet
The Girl in the Pink Shirt	La niña de la camiseta rosa
Dancing with God: Emerging in Sacredness—A Daughters of God Retreat	Bailar con Dios: emerger en lo sagrado, un retiro de las Hijas de Dios
Circles of Trust: An Experience in Soul Sharing	Círculos de confianza: una experiencia donde las almas comparten
The Greatest Stories Ever Told	Las historias más grandes jamás contadas
Volume 11, Issue 2, June 2017	Volumen 11, Número 2, junio 2017
Welcome & Contact Details	Bienvenida e información de contacto
Seeding The Urantia Book in the Philippines: Tour Number Three	Sembrando El Libro de Urantia en Filipinas: Gira número tres
Noteworthy Decisions from the April 2017 Board of Trustees Meeting	Decisiones destacadas de la reunión del Patronato de abril de 2017
Translations and Unity	Traducciones y Unidad
BookExpo America 2017	LibroExpo América 2017
The UBIS Experience	La experiencia UBIS
The International Book Fair in Bogotá	La Feria Internacional del Libro de Bogotá
God in Man—The Spanish Readers Gather	Dios en el hombre: los lectores españoles se reúnen
What Can the Emerging Philosophy of Living Do?	¿Qué puede hacer la filosofía de vida emergente?
Spiritual Rebirth—How The Urantia Book Transformed Me	Renacimiento espiritual: cómo me transformó el libro de Urantia
Announcements	Anuncios
Volume 11, Issue 3, Oct. 2017	Volumen 11, Número 3, octubre 2017
Welcome & Contact Details	Bienvenida e información de contacto
Free Downloads of The Urantia Book at urantia.org	Descargas gratuitas de El libro de Urantia en urantia.org
Noteworthy Decisions from the July 2017 Board of Trustees Meeting	Decisiones destacadas de la reunión de julio de la Junta de Fideicomisarios - 2017
Urantia Foundation's Index of The Urantia Book	El Índice de El libro de Urantia de la Fundación Urantia
Dancing With God: Emerging In Sacredness- A Retreat For Women At Urantia Foundation	Bailar con Dios: Emerger en lo sagrado. Un retiro de mujeres en la Fundación Urantia
The 2018 Urantia Association International Conference	La Conferencia 2018 de la Asociación Urantia Internacional
The IC'17 Children's Program: How I Got By With A Lot Of Help From My Friends!	El programa infantil de la IC17: ¡cómo me las arreglé con mucha ayuda de mis amigos!
Signs and Wonders	Señales y prodigios
Ask and You Shall Receive	Pedid y recibiréis
Volume 11, Issue 4, Dec. 2017	Volumen 11, Número 4, diciembre 2017
Welcome & Contact Details	Bienvenida e información de contacto
Curing Blindness in Ethiopia	Curar la ceguera en Etiopía
Noteworthy Decisions from the October 2017 Board of Trustees Meeting	Decisiones destacadas de la reunión de octubre de la Junta de Fideicomisarios - 2017
The Spanish Revision Team Visits Urantia Foundation	El equipo de la revisión de la traducción al español visita la Fundación Urantia
2017 Year-end Match	Igualación de fin de año 2017
Sending Donations to Urantia Foundation	Envío de donaciones a la Fundación Urantia
A Look into the Future	Una mirada al futuro
A Urantia Book Booth at the Miami Book Fair	Stand de El libro de Urantia en la Feria del Libro de Miami
Season's Greetings: Reflections on True Gifts from The Urantia Book	Felicitaciones navideñas: reflexiones sobre los verdaderos regalos de El libro de Urantia
Volume 12, 2018	Volumen 12, 2018
Volume 12, Issue 1, March 2018	Volumen 12, Número 1, marzo 2018
Welcome & Contact Details	Bienvenida e información de contacto
The Revelation Bridge Endowment Fund-Securing the Future for The Urantia Book and Its Teachings	El Fondo de Dotación del Puente de la Revelación: asegurar el futuro de El libro de Urantia y sus enseñanzas
Noteworthy Decisions from the January 2018 Board of Trustees Meeting	Decisiones destacadas de la reunión de enero de la junta de fideicomisarios - 2018
Sending Le Livre d'Urantia to Cameroon	Envío de Le Livre d’Urantia a Camerún
Urantia Book Internet School-Fellowship Across the Globe	La Escuela de El libro de Urantia en Internet: compañerismo por todo el mundo
The Urantia Book in Fiji	El libro de Urantia en Fiji
Urantia Association and Urantia Foundation Meet at 533 in Chicago	La Reunión de la Asociación Urantia y la Fundación Urantia en el 533 en Chicago
Remembering Larry Watkins—Treasured Server of the Urantia Revelation	En recuerdo de Larry Watkins, un valioso servidor de la revelación Urantia
Appreciating Sue Tennant	En recuerdo de Sue Tennant
The Pipeline Of Light—Seeding The Urantia Book Worldwide	Pipeline of Light: la siembra de El libro de Urantia por el mundo
A Way To Be of Service	Una manera de servir
What The Urantia Book Means to Me	Lo que El libro de Urantia significa para mí
The Urantia Book Fellowship's Summer Study Session 2018	La Sesión de Estudio de Verano 2018 de la Urantia Book Fellowship
“Dancing with God—Courageously Living His Love”	«Bailar con Dios: vivir su amor con valentía»
Volume 12, Issue 2, July 2018	Volumen 12, Número 2, julio 2018
Welcome & Contact Details	Bienvenida e información de contacto
Richard Keeler Retires	Richard Keeler se retira
Noteworthy Decisions from the April 2018 Board of Trustees Meeting	Decisiones destacadas de la reunión de abril de la Junta de Fideicomisarios - 2018
The Parables Book—A Resource for Outreach	El libro de las parábolas, un recurso de asistencia
A Knowledgeable Guide to Point the Way—Urantia Foundation's Index	Guía experta para señalar el camino: el Índice de la Fundación Urantia
Jesus as a Teacher—2018 International Conference in Amsterdam	Jesús como instructor: conferencia internacional 2018 en Ámsterdam
Ghana—The Teachings Spread with Conferences and Gift Books	Ghana: las enseñanzas se difunden con conferencias y donación de libros
Celebrating Marjorie Reed	Celebración de Marjorie Reed
Spreading The Urantia Book Throughout Italy	La difusión de El libro de Urantia en Italia
Announcements	Anuncios
Volume 12, Issue 3, Oct. 2018	Volumen 12, Número 3, octubre 2018
Welcome & Contact Details	Bienvenida e información de contacto
A Way to Serve and to Seed-Urantia Foundation Sends 600 Books to Latin America	Una manera de servir y de sembrar: la Fundación Urantia envía 600 libros a América Latina
Noteworthy Decisions from 2 the July 2018 Board of Trustees Meeting	Decisiones destacadas de la reunión de julio de la Junta de Fideicomisarios - 2018
Update: Outreach in the Philippines	Novedades de las actividades en Filipinas
The Challenges of Translating The Urantia Book	Los retos de traducir El libro de Urantia
The Urantia Book Study Group Directory Launched a New Website	El Directorio de Grupos de Estudio de El libro de Urantia ha lanzado su nueva web
Reflections of the 2018 Summer Study Session	Reflexiones sobre la Sesión de Estudio de Verano 2018
Urantia Foundation to Attend the 2018 Parliament of the World's Religions	La Fundación Urantia asistirá al Parlamento de las Religiones del Mundo 2018
What The Urantia Book Means to Me	Lo que El libro de Urantia significa para mí
Announcements	Anuncios
Volume 12, Issue 4, Dec. 2018	Volumen 12, Número 4, diciembre 2018
Welcome & Contact Details	Bienvenida e información de contacto
It's the Season of Giving	Es tiempo de dar
Noteworthy Decisions from the October 2018 Board of Trustees Meeting	Decisiones destacadas de la reunión de octubre de la Junta de Fideicomisarios - 2018
UBIS Gets a Makeover	Cambio de imagen de la UBIS
Our Experiences at the 2018 Parliament of the World 's Religions	Nuestra experiencia en el Parlamento de las Religiones del Mundo 2018
Dancing with God: The Fifth Annual Women's Retreat	Bailar con Dios: el quinto retiro anual de mujeres
Seeding The Urantia Book in Romania	La siembra de El libro de Urantia en Rumanía
What The Urantia Book Means to Me	Lo que El libro de Urantia significa para mí
Announcements	Anuncios
Volume 13, 2019	Volumen 13, 2019
Volume 13, Issue 1, April 2019	Volumen 13, Número 1, abril 2019
Welcome & Contact Details	Bienvenida e información de contacto
Our Brother Richard	Nuestro hermano Richard
Noteworthy Decisions from the January 2019 Board of Trustees Meeting	Decisiones destacadas de la reunión de enero de la Junta de Fideicomisarios - 2019
The Untold Story of Jesus: A Modern Biography from The Urantia Book	La historia no contada de Jesús: biografía moderna según El libro de Urantia
Global Cultural Symposium at Urantia Foundation	Simposio Cultural Mundial en la Fundación Urantia
The UBIS Experience—Behind the Scenes	La experiencia de la UBIS tras las bambalinas
What The Urantia Book Means to Me 	Lo que el libro de Urantia significa para mí
Announcements	Anuncios
Volume 13, Issue 2, July 2019	Volumen 13, Número 2, julio 2019
Welcome & Contact Details	Bienvenida e información de contacto
Creating Translations out of Love: Urantia Foundation's Quality Process	Crear traducciones con amor: el control de calidad de la Fundación Urantia
Noteworthy Board Decisions from the April 2019 Trustees Meeting	Decisiones destacadas de la reunión de abril de la Junta de Fideicomisarios
Urantia Foundation's Global Cultural Symposium	Simposio Cultural Mundial de la Fundación Urantia
My Personal Experience At The Cultural Symposium	Mi experiencia personal en el simposio cultural
Ways to Help Spread the Urantia Revelation	Maneras de ayudar a divulgar la Revelación Urantia
CosmicCreations—Our Service Project	CosmicCreations, nuestro proyecto de servicio
Celebrating Moussa N'Diaye and Norman Ingram	Celebración de Moussa N'Diaye y Norman Ingram
What The Urantia Book Means to Me	Lo que el libro de Urantia significa para mí
Announcements	Anuncios
Volume 13, Issue 3, Oct. 2019	Volumen 13, Número 3, octubre 2019
Welcome & Contact Details	Bienvenida e información de contacto
The Spanish Revision Is Almost Finished	La revisión al español casi ha terminado
Noteworthy Board Decisions from the July 2019 Trustees Meeting	Decisiones destacadas de la reunión de julio de la Junta de Fideicomisarios - 2019
Study Groups and Translations	Grupos de estudio y traducciones
The Second UAI European Conference in Tallinn	La II Conferencia Europea de la AUI en Tallin
Remembering Mark Bloomfield	En recuerdo de Mark Bloomfield
Announcements	Anuncios
Volume 13, Issue 4, Dec. 2019	Volumen 13, Número 4, diciembre 2019
Welcome & Contact Details	Bienvenida e información de contacto
Together We Can Make a Diference	Juntos podemos marcar la diferencia
Noteworthy Decisions from the October 2019 Trustees Meeting	Decisiones destacadas de la reunión de octubre de los fideicomisarios - 2019
My Impressions of the Spanish Revision	Mis impresiones sobre la revisión al español
Science Symposium 2019	Simposio Científico 2019
A Celebration of Souls	Celebración de las almas
The Presence of Urantia Peru at the Cusco International Book Fair 2019	La presencia de Urantia Perú en la Feria del Libro Internacional de Cuzco 2019
The Word, the Language, the Dictionary	La palabra, el idioma, el diccionario
Dancing with God—Our Supreme Calling Retreat	Retiro «Bailar con Dios: nuestra llamada suprema»
Seattle Hempfest Report	Informe sobre el Hempfest de Seattle
An Essay on Finding Truth	Ensayo sobre la búsqueda de la Verdad
Announcements	Anuncios
Volume 14, 2020	Volumen 14, 2020
Volume 14, Issue 1, April 2020	Volumen 14, Número 1, abril 2020
Welcome & Contact Details	Bienvenida e información de contacto
A Filipino Translation of The Urantia Book	Traducción al filipino de El libro de Urantia
Noteworthy Decisions from 2 the January 2020 Trustees Meeting	Decisiones destacadas de la reunión de enero de la Junta de Fideicomisarios - 2020
Remembering Carmelo María Martínez Ortiz De Zarate 1947-2020	En recuerdo de Carmelo María Martínez Ortiz de Zárate 1947-2020
Online Education—A Global Mission	Educación en línea: una misión mundial
The 2019 Urantia Book Conference in the Philippines	La Conferencia de El libro de Urantia en Filipinas 2019
A Story of Three Audiobooks	Historia de tres audiolibros
Sharing The Urantia Book	Compartir El libro de Urantia
Announcements	Anuncios
Volume 14, Issue 2, June 2020	Volumen 14, Número 2, junio 2020
Welcome & Contact Details	Bienvenida e información de contacto
The Indonesian Translation: A Journey with The Urantia Book	La traducción al indonesio: un viaje con El libro de Urantia
Updates from the April 2020 Board Meeting	Novedades de la reunión de abril 2020 de la Junta
Steve Dreier: A Tribute	Homenaje a Steve Dreier
Urantia Association's Second 24-Hour Online Event	Segundo evento de 24 horas de la Asociación Urantia
What The Urantia Book Means to Me	Lo que El libro de Urantia significa para mí
Announcements	Anuncios
Volume 14, Issue 3, Oct. 2020	Volumen 14, Número 3, octubre 2020
Welcome & Contact Details	Bienvenida e información de contacto
The First Chinese Conference: An Unprecedented International Endeavor	Primera conferencia en China: un esfuerzo internacional sin precedentes
Updates from the July 2020 Trustee Meeting	Novedades de la reunión de julio de los fideicomisarios - 2020
The Satisfactions of (Reader) Service	Las satisfacciones del servicio (a los Lectores)
The Urantia Book Historical Society has a New Archive	La Urantia Book Historical Society tiene un nuevo archivo
What The Urantia Book Means to Me	Lo que El libro de Urantia significa para mí
Planned Giving	Planear un legado
Announcements	Anuncios
Volume 14, Issue 4, Dec. 2020	Volumen 14, Número 4, diciembre 2020
Welcome & Contact Details	Bienvenida e información de contacto
Infinite Treasures Are Ours	Infinitos tesoros son nuestros
The Standard Reference Text—Historical Context and Purpose	El Texto de Referencia Estándar: contexto histórico y propósito
Updates from the October 2020 Trustee Meeting	Novedades de la junta de fideicomisarios de octubre - 2020
Chinese Conference Generates Enthusiasm for The Urantia Book	La conferencia china genera entusiasmo hacia El libro de Urantia
Remembering Carolyn Kendall	En recuerdo de Carolyn Kendall
Urantia Book Internet School—an Opportunity for Spiritual Growth and Brotherhood	La Escuela de El libro de Urantia en Internet: una oportunidad para el crecimiento espiritual y la hermandad
Urantia Book Internet School—a Brazilian Experience	La Escuela de El libro de Urantia en Internet: una experiencia brasileña
What The Urantia Book Means to Me-the Dimensions of God	Lo que El libro de Urantia significa para mí: las dimensiones de Dios
Announcements	Anuncios
Volume 15, 2021	Volumen 15, 2021
Volume 15, Issue 1, April 2021	Volumen 15, Número 1, abril 2021
Welcome & Contact Details	Bienvenida e información de contacto
Springtime for the New El libro de Urantia	Primavera para el nuevo Libro de Urantia
Updates from the January 2021 Trustee Meeting	Novedades de la reunión de enero de la junta de fideicomisarios - 2021
The Urantia Book in Europe—Our Journey Building a Distribution Network	El libro de Urantia en Europa: nuestro viaje de creación de una red de distribución
Loving Service Spiritual Retreat —The Power of Stories	Retiro espiritual virtual de la Fundación Urantia: el poder de las historias
Urantia Foundation Outreach Committee	Comité de Asistencia de la Fundación Urantia
Dancing with God—Living in Love in Trying Times	Bailar con Dios: Vivir en amor en tiempos difíciles
New Enhanced English E-book	Nuevo libro electrónico en inglés mejorado
Learn About the New Revision of El Libro de Urantia	Conozcan la nueva revisión de El libro de Urantia
Volume 15, Issue 2, July 2021	Volumen 15, Número 2, julio 2021
Welcome & Contact Details	Bienvenida e información de contacto
Taking It to a New Level: The Urantia Book in Esperanto	Llevarlo al siguiente nivel: El libro de Urantia en esperanto
Updates from the April 2021 Trustee Meeting	Novedades de la junta de abril de los fideicomisarios - 2021
My Experiences with the Spanish Revision	Mi experiencia con la revisión al español
Distributing Het Urantia Boek in the Netherlands and Belgium	La distribución de Het Urantia Boek en los Países Bajos y Bélgica
Experiencing International Brotherhood through Urantia Book Internet School	La experiencia de la hermandad internacional a través de la Escuela de El libro de Urantia en Internet
Teamwork: A Virtual Conference Experience	Trabajo en equipo: la experiencia de una conferencia virtual
What The Urantia Book Means to Me	Lo que El libro de Urantia significa para mí
Announcements	Anuncios
Volume 15, Issue 3, Sept. 2021	Volumen 15, Número 3, septiembre 2021
Welcome & Contact Details	Bienvenida e información de contacto
Maximizing Outreach with an Android App	Maximizar el alcance con una app de Android
Updates from the July Trustee Meeting	Novedades de la reunión de julio de los fideicomisarios - 2021
A Decade of Quality and Dedication — the Revision of El Libro de Urantia	Una década de calidad y dedicación: la revisión de El libro de Urantia
The Effect of Supply Chains on Book Printing and Distribution	El efecto de las cadenas de suministro en la impresión y distribución de libros
The Enduring Legacy of Two Great Teachers	El legado duradero de dos grandes maestros
A Quadrimillennial Appreciation of Machiventa Melchizedek	Gratitud en el cuarto milenio de Maquiventa Melquisedec
Three Concentric Circles — Our Michael Son's Banner	Tres círculos concéntricos: la bandera de nuestro Hijo Miguel
Sharing The Urantia Book	Compartir El libro de Urantia
What The Urantia Book Means to Me	Lo que El libro de Urantia significa para mí
Science Symposium III	III Simposio Científico
Volume 16, 2022	Volumen 16, 2022
Volume 16, Issue 1, Jan. 2022	Volumen 16, Número 1, enero 2022
Welcome & Contact Details	Bienvenida e información de contacto
2022 Here We Come!	¡2022, allá vamos!
Updates from the October 2021 Trustee Meeting	Novedades de la reunión de octubre de los fideicomisarios - 2022
The Chinese Translation: An Update	Novedades de la traducción al chino
Circling the Globe with UBIS	La vuelta al mundo con la UBIS
My Benelux Esperanto Conference Experience	Mi experiencia en la Conferencia de Esperanto del Benelux
Remembering Irmeli Ivalo-Sjõlie	En recuerdo de Irmeli Ivalo-Sjölie
Sharing The Urantia Book	Compartir El libro de Urantia
What The Urantia Book Means to Me	Lo que El libro de Urantia significa para mí
Volume 16, Issue 2, March 2022	Volumen 16, Número 2, marzo 2022
Welcome & Contact Details	Bienvenida e información de contacto
Ksiega Urantii: How the Polish Translation Came to Be	Księga Urantii: cómo llegó la traducción al polaco
Updates from the January 2022 Trustee Meeting	Novedades de la reunión de enero de los fideicomisarios - 2022
The Inquiring Greeks: A Chronicle of the Greek Translation of The Urantia Book	Los griegos inquisitivos: crónica de la traducción al griego de El libro de Urantia
Urantia Foundation: Enhancing a Global Movement	Fundación Urantia: extender un movimiento mundial
An Indispensable Partnership: The Pipeline of Light	Una colaboración indispensable: Pipeline of Light
Collaboration and Spiritual Unity: The Urantia Book Study Group Directory	Colaboración y unidad espiritual: el Directorio de Grupos de Estudio de El libro de Urantia
Joining the Team at Urantia Foundation	Unirse al equipo de la Fundación Urantia
Sharing The Urantia Book	Compartir El libro de Urantia
What The Urantia Book Means to Me	Lo que El libro de Urantia significa para mí
Announcements	Anuncios
Volume 16, Issue 3, July 2022	Volumen 16, Número 3, julio 2022
Welcome & Contact Details	Bienvenida e información de contacto
Science: The Interface of Evolution and Revelation	Ciencia: la interfaz entre evolución y revelación
Updates from the April 2022 Trustee Meeting	Novedades de la reunión de abril de los fideicomisarios - 2022
The Cultural Advisory Council Welcomes Brazil	El Consejo Consultivo Cultural da la bienvenida a Brasil
Urantia Book Internet School—Study Groups for New Readers	Escuela de El libro de Urantia en Internet: grupos de estudio para lectores nuevos
Three Ways to Help Spread the Urantia Revelation	Tres maneras de ayudar a difundir la revelación Urantia
A Tribute to Dr. Marta Elders—Our Love of a Lady	Homenaje a la Dra. Marta Elders: nuestro amor a una dama
What The Urantia Book Means to Me	Lo que el libro de Urantia significa para mí
Announcements	Anuncios
Volume 16, Issue 4, Oct. 2022	Volumen 16, Número 4, octubre 2022
Welcome & Contact Details	Bienvenida e información de contacto
Urantia Books across the Globe	Libros de Urantia por todo el mundo
Updates from the July 2022 Trustee Meeting	Novedades de la reunión de julio de los fideicomisarios - 2022
Quality TranslationsA 40—Year Process!	Traducciones de calidad: un proceso de 40 años
The Revelation Flourishes in the Philippines	La revelación prospera en Filipinas
Serving as Trustees of Urantia Foundation	Servir como fideicomisarios de la Fundación Urantia
The Cultural Advisory Council Welcomes Colombia	El Consejo Asesor Cultural da la bienvenida a Colombia
Growing a School out of Love for the Revelation	Hacer crecer una escuela por amor a la revelación
Sharing The Urantia Book	Compartir El libro de Urantia
What The Urantia Book Means to Me	Lo que el libro de Urantia significa para mí
Announcements	Anuncios
Volume 16, Issue 5, Dec. 2022	Volumen 16, Número 5, diciembre 2022
Welcome & Contact Details	Bienvenida e información de contacto
The Assurance of God's Unbreakable Promises	La seguridad de las promesas inquebrantables de Dios
Updates from the October 2022 Trustee Meeting	Novedades de la reunión de octubre de los fideicomisarios - 2022
The Cultural Advisory Council Welcomes Poland	El Consejo Consultivo Cultural da la bienvenida a Polonia
Nurturing the Revelation in the Philippines	Cultivar la revelación en Filipinas
Our Urantia Book Stand at the Cali, Colombia Bookfair	Nuestro stand de El libro de Urantia en la Feria del Libro de Cali-Colombia
Third European Conference of Urantia Book Readers—Overcoming Materialism and Enlightening Europe	III Conferencia Europea de Lectores de El libro de Urantia: Superar el materialismo, iluminar Europa
Sharing The Urantia Book	Compartir El libro de Urantia
What The Urantia Book Means to Me	Lo que El Libro de Urantia significa para mí
Announcements	Anuncios
Volume 17, 2023	Volumen 17, 2023
Volume 17, Issue 1, March 2023	Volumen 17, Número 1, marzo 2023
Welcome & Contact Details	Bienvenida e información de contacto
The Mustard Seed Grants Program	El Programa de Subvenciones Semilla de Mostaza
Updates from the January 2023 Trustee Meeting	Novedades de la reunión de enero de los fideicomisarios - 2023
An Epochal Plan	Un plan de época
Urantia Book International School Virtual Study Groups	Grupos de estudio virtuales de la Escuela Internacional de El libro de Urantia
Remembering Tonia Baney	En recuerdo de Tonia Baney
What The Urantia Book Means to Me	Lo que El libro de Urantia significa para mí
Announcements	Anuncios
Volume 17, Issue 2, June 2023	Volumen 17, Número 2, Junio 2023
Welcome & Contact Details	Bienvenida e información de contacto
Remembering Seppo Kanerva—a Letter to a Brother, Friend, and Colleague	En recuerdo de Seppo Kanerva: carta a un hermano, amigo y colega
Updates from the April 2023 Trustee Meeting	Novedades de la reunión de fideicomisarios de abril 2023
“Spreading the Good News” Tour	Gira «Difundir la buena nueva»
Wikipedia and The Urantia Book	Wikipedia y El libro de Urantia
Remembering John Hales	En recuerdo de John Hales
Remembering Paula Padilla	En recuerdo de Paula Padilla
What The Urantia Book Means to Me - Luis Costa	Lo que El libro de Urantia significa para mí - Luis Costa
Announcements	Anuncios
Volume 17, Issue 3, October 2023	Volumen 17, Número 3, Octubre 2023
Welcome & Contact Details	Bienvenida e información de contacto
The Philippines—Energized by the Spirit of Revelation	Filipinas vigorizada por el espíritu de la revelación
Updates from the July 2023 Trustee Meeting	Novedades de la reunión de fideicomisarios de julio 2023
Contagious Love—A Mustard Seed Grows in Nigeria	Amor contagioso: una semilla de mostaza crece en Nigeria
The Parliament of the World’s Religions	El Parlamento de las Religiones del Mundo
Remembering Nancy Johnson	En memoria de Nancy Johnson
What The Urantia Book Means to Me - Doug McKeever	Lo que El libro de Urantia significa para mí - Doug McKeever
Announcements	Anuncios
Volume 17, Issue 4, December 2023	Volumen 17, Número 4, Diciembre 2023
Welcome & Contact Details	Bienvenida e información de contacto
A Path to World Peace and Progress	Un camino hacia la paz y el progreso mundiales
Updates from the October 2023 Trustee Meeting	Novedades de la reunión de octubre 2023 de los fideicomisarios
Doing Good to Others—Outreach in the Philippines	Hacer el bien a los demás: asistencia en Filipinas
Urantia Book International School—A Silver Jubilee	Bodas de plata de la Escuela Internacional de El libro de Urantia
Reflections from the Cultural Advisory Council	Reflexiones del Consejo Asesor Cultural
Memories of the Third Latin American Urantia Conference in Mexico	Recuerdos de la III Conferencia Urantia de América Latina de Urantia en México
What The Urantia Book Means to Me - Yeesook Yoon	Lo que El libro de Urantia significa para mí - Yeesook Yoon
Announcements	Anuncios