Index of International Urantia Association's “Tidings” articles	Indice de artículos del Tidings de la Asociación Urantia Internacional
2014	2014
Tidings — December 2014	Tidings — diciembre 2014
Tidings — December 2014 — Content	Tidings — Noticias y actualizaciones de la IUA — noviembre-diciembre de 2014
President’s Message	Mensaje del Presidente de diciembre de 2014
Virginia-Carolina Readers 12th Annual Conference	12.ª Conferencia Anual de Lectores de Virginia Carolina
2015 Easter Spirit Renewal and Sacred Art Retreat	2015 Retiro de Renovación del Espíritu de Pascua y Arte Sacro
Urantia Book Readers in Nigeria	Lectores del libro de Urantia en Nigeria
Young Reader Study Group in Boulder	Grupo de estudio de jóvenes lectores en Boulder
Teaching and Facilitating in the UBIS	Docencia y Facilitación en la UBIS
Mini-Study Guide	Mini guía de estudio
International Conference 2015 Update	Actualización de la Conferencia Internacional 2015
2015	2015
Tidings — February 2015	Tidings — febrero 2015
Tidings — February 2015 — Content	Tidings — Noticias y actualizaciones de la IUA — Febrero 2015
President’s Message	President’s February 2015 Message
2015 Urantia Association International Conference	Conferencia Internacional 2015 – Quebec
2015 International Conference Program Schedule	Programa de la Conferencia Internacional 2015
Spreading The Urantia Book in Ukraine	Difundiendo El Libro de Urantia en Ucrania
New International Service Board Members	Nuevos miembros de la Junta de Servicio Internacional
Virtual Study Group, Symmetry of Soul	Grupo de Estudio Virtual – Simetría del Alma
Farewell to Shirley Pelland	Adiós a Shirley Pelland
Tidings — April 2015	Tidings — abril 2015
Tidings — April 2015 — Content	Tidings — Noticias y actualizaciones de la IUA — abril 2015
President’s Message	Mensaje del presidente – abril 2015
2015 International Conference – Quebec	Conferencia Internacional 2015 – Quebec
Journal – March 2015 Issue Now Available	El Journal de marzo 2015 ya está disponible
Lone Star Urantia Association Conference	Conferencia de la Lone Star Urantia Association
Summer Study Session 2015	Sesión de Estudio de Verano 2015 de la Urantia Book Fellowship
Private: Thank You to Outgoing Board Members	Privado: Gracias a los miembros salientes de la Junta
Tidings — June 2015	Tidings — junio 2015
Tidings — June 2015 — Content	Tidings — Noticias y actualizaciones de la IUA — junio 2015
President’s June 2015 Message	Mensaje del presidente – junio 2015
Urantia International Conference – Quebec	Conferencia de la Asociación Urantia Internacional – Quebec
Summer Meeting 2015 in the UK	Reunión de verano 2015 en el Reino Unido
Italian Urantia Meeting	Reunión Urantia en Italia
Women’s Retreat	Retiro de mujeres
The Importance of Study Groups	La importancia de los grupos de estudio
International Study Day Reflections	Reflexiones sobre el Día Internacional del Estudio
International Book Fair in Bogotá, Colombia	Feria Internacional del Libro de Bogotá (Colombia)
Urantia Association of Spain Meets	La Asociación Urantia de España celebra su XIV Encuentro de lectores
Blue Club Meeting in Frankfurt	Reunión del Blue Club en Frankfurt
Readers Meet in Brazil	Encuentro de lectores en Brasil
Feedback from a Urantia Book Recipient	Respuesta de un receptor de El libro de Urantia
International Service Board at Work	El trabajo de la Junta Internacional de Servicio
Tidings — August 2015	Tidings — agosto 2015
Tidings — August 2015 — Content	Tidings — Noticias y actualizaciones de la IUA — agosto 2015
President’s Message August 2015	Mensaje del presidente – agosto 2015
2015 International Conference – Quebec, Canada	Conferencia Internacional 2015 – Quebec, Canadá
Quebec Conference Reflections	Reflexiones sobre la conferencia de Quebec
Success Stories – Urantia Books Distribution in Malawi	Historias de éxito – Distribución de El libro de Urantia en Malawi
French National Meeting	Encuentro nacional francés
Summer Conference in Finland	Conferencia de verano en Finlandia
The Dutch Urantia Annual Meeting Day	El Día de Reunión Anual en Holanda
Jesus’ Birthday in NY-Pennsylvania	El cumpleaños de Jesús en Nueva York y Pensilvania
Spiritual Unity in New England	Unidad espiritual en Nueva Inglaterra
International Service Board at Work – 2nd Quarter Report for 2015	Trabajo de la Junta Internacional de Servicio – informe del segundo trimestre de 2015
Tidings — October 2015	Tidings — octubre 2015
Tidings — October 2015 — Content	Tidings — Noticias y actualizaciones de la IUA — octubre 2015
President’s Message October 2015	Mensaje del presidente – octubre 2015
Three Summer Exhibitions in Ukraine	Tres exposiciones de verano en Ucrania
Jointly Sponsored Conference in the USA	Conferencia patrocinada conjuntamente en los EEUU
Urantia Young Adult International (UYAI) Study Group	Grupo de estudio Urantia Young Adult International (UYAI)
Italian Conference Report	Informe sobre la conferencia italiana
Brazil National Meeting	Reunión nacional de Brasil
ANZURA Annual Urantia Book Readers’ Conference	Conferencia anual de ANZURA de lectores de El libro de Urantia
UAIUK Summer Meeting, 2015	Reunión de Verano 2015 de la UAIUK
Venezuela Conference for Urantia Book Readers	Conferencia de lectores de El libro de Urantia de Venezuela
Study Group Directory	Directorio de Grupos de Estudio
Donate while Shopping with Amazon	Donar al comprar en Amazon
Tidings — December 2015	Tidings — diciembre 2015
Tidings — December 2015 — Content	Tidings — Noticias y actualizaciones de la IUA — diciembre 2015
President’s Message December 2015	Mensaje del presidente – diciembre 2015
Urantia Young Adult Online Study Group	Grupo de estudio virtual Urantia Young Adult
San Antonio, USA Conference June 2016	Conferencia en San Antonio (EEUU), junio de 2016
Jesus’ Birthday in His Homeland	Cumpleaños de Jesús en su tierra natal
Dancing with God	Bailar con Dios
Parliament of World’s Religions Report	Crónica del Parlamento de las Religiones del Mundo
The Urantia Book Study Group Directory	El Directorio de Grupos de Estudio de El libro de Urantia
International Service Board at Work – 3rd Quarter 2015	Trabajo de la Junta Internacional de Servicio – 3er trimestre 2015
2016	2016
Tidings — March 2016	Tidings — marzo 2016
Tidings — March 2016 — Content	Tidings — Noticias y actualizaciones de la IUA — marzo 2016
President’s Message March 2016	Mensaje del presidente – marzo 2016
Urantia Association’s Social Media	La Asociación Urantia en las redes sociales
German-speaking Urantia Book Readers’ Meeting	Reunión de lectores germanohablantes de El libro de Urantia
Winter Conference in Finland	Conferencia de invierno en Finlandia
ANZURA Conference Tasmania 2016	Conferencia de Anzura 2016 en Tasmania
Seeding The Urantia Book	Sembrar El libro de Urantia
Study Group Committee in the Making	El Comité de Grupos de Estudio en construcción
Farewell Herrol Dallaire, Quebec	Hasta siempre, Herrol Dallaire (Quebec)
Urantia University Institute	El Urantia University Institute
International Service Board at Work - 4th Quarter 2015	Trabajo de la Junta Internacional de Servicio – 4º trimestre de 2015
Tidings — June 2016	Tidings — junio 2016
Tidings — June 2016 — Content	Tidings — Noticias y actualizaciones de la IUA — junio 2016
President’s Message June 2016	Mensaje del Presidente junio de 2016
Call for Membership Coordinators	Se busca coordinadores de miembros
Latin American Urantia Conference – Bogota	Conferencia Urantia Latinoamericana – Bogotá
Ukraine Advertising Campaign	Primera campaña publicitaria de El libro de Urantia en Ucrania
Rejuvenating Your Study Group	Rejuvenecer su grupo de estudio
International Service Board at Work - 1st Quarter 2016	Trabajo de la Junta Internacional de Servicio – primer trimestre de 2016
Tidings — September 2016	Tidings — septiembre 2016
Tidings — September 2016 — Content	Tidings — Noticias y actualizaciones de la IUA — septiembre 2016
President’s Message – September 2016	Mensaje del presidente – septiembre 2016
San Antonio Conference Reflections	Reflexiones acerca de la conferencia de San Antonio
European Urantia Conference, Budapest	Conferencia Urantia Europea de Budapest
Latin American Urantia Conference, Bogotá	Conferencia Urantia Latinoamericana (Bogotá)
Meeting for Urantia Book Readers in Russia	Reunión de lectores de El libro de Urantia en Rusia
Sharing The Urantia Book through Webinars	Compartir El libro de Urantia mediante seminarios web
Italian-French-Swiss Urantia Conference	Conferencia Urantia italo-franco-suiza
The Bogotá International Book Fair	La Feria Internacional del Libro de Bogotá
Meeting of Urantia Book Readers in Spain	Encuentro de lectores de El libro de Urantia en España
My Experience with The Urantia Book	Mi experiencia con El libro de Urantia
Tidings — Cathy Jones Special Issue	Tidings — Número Especial sobre Cathy Jones
Tidings — Cathy Jones Special Issue — Content	Tidings — Noticias y actualizaciones de la IUA — Cathy Jones — Número especial 2016
Tidings — November 2016	Tidings — noviembre 2016
Tidings — November 2016 — Content	Tidings — Noticias y actualizaciones de la IUA — noviembre 2016
Budapest Conference Report	Informe de la Conferencia de Budapest
Bogota Conference Report	Informe de la Conferencia de Bogotá
Tasmanian Conference Reflections	Reflexiones de la Conferencia de Tasmania
Russian Conference Report	Informe de la Conferencia Rusa
Italian Conference Report	Informe de la Conferencia Italiana
Study Groups and Young People	Los grupos de estudio y la gente joven
Dutch Urantia Meeting 21st August	Reunión Urantia en Holanda el 21 de agosto
The Urantia Book Internet School	La Escuela de El libro de Urantia en Internet
Inspiration & Healing From The Urantia Book	Inspiración y cura que proporciona El libro de Urantia
2017	2017
Tidings — March 2017	Tidings — marzo 2017
Tidings — March 2017 — Content	Tidings — Noticias y actualizaciones de la IUA — marzo 2017
Transition to Unity	La transición a la unidad
President’s Message – March 2017	Mensaje del presidente – marzo 2017
Urantia DACH Annual Meeting in Frankfurt	Reunión anual de Urantia DACH en Frankfurt
UK Urantia Book Readers’ Meeting with Pato Banton	Reunión de lectores de El libro de Urantia en el Reino Unido con Pato Banton
Study Groups – A Key Tool	Los grupos de estudio, una herramienta clave
Responses to Call from Young Reader Feedback	Respuestas a la llamada a jóvenes lectores
International Service Board Elections	Elecciones a la Junta Internacional de Servicio
Tidings — June 2017	Tidings — junio 2017
Tidings — June 2017 — Content	Tidings — Noticias y actualizaciones de la IUA — junio 2017
President’s Message – June 2017	Mensaje del presidente – junio 2017
2018 Urantia International Conference	Conferencia Internacional Urantia 2018
Announcements	Anuncios
Unity Initiative Report	Informe de la iniciativa de unidad
Bogotá Book Fair	La Feria del Libro de Bogotá
Spanish Urantia Book Readers Meet	XVI Encuentro de lectores de El libro de Urantia en España
Our Trilogy Mission – London, Birmingham & Ghana	Nuestra misión triple en Londres, Birmingham y Ghana
Study Groups and Us—Survey Results	Los grupos de estudio y nosotros: resultados de la encuesta
Youth & Study Groups	Los jóvenes y los grupos de estudio
Young Readers & Study Groups	Lectores jóvenes y grupos de estudio
Dutch Speaking Urantia Conference—21st August	Conferencia Urantia de habla holandesa—21 de agosto
Daughters of God Women’s Retreat	Retiro de mujeres de las Hijas de Dios
Story from India	Una historia de la India
Tidings — September 2017	Tidings — septiembre 2017
Tidings — September 2017 — Content	Tidings — Noticias y actualizaciones de la IUA — septiembre 2017
President’s Message – September 2017	Mensaje del presidente – septiembre 2017
An Experiment for Study Groups	Experimento en el grupo de estudio
Bolivia Book Fair, Santa Cruz	Feria del Libro de Bolivia en Santa Cruz
Book Fair in Lima, Perú 	Feria del Libro de Lima (Perú) 
Ecuador Conference	Conferencia de Ecuador 
European Blue Club Meeting	Reunión del Blue Club europeo
French National Meeting	Encuentro nacional francés
Passing the Torch of Light to Future Generations	Pasando la antorcha de luz a las generaciones futuras
Tidings — December 2017	Tidings — diciembre 2017
Tidings — December 2017 — Content	Tidings — Noticias y actualizaciones de la IUA — diciembre 2017
President’s Message – December 2017	Mensaje del presidente – diciembre 2017
International Goals for 2021	Metas internacionales para 2021
International Conference 2018 Update	International Conference 2018 Update
Financial Aid – 2018 International Conference	Ayuda económica – Conferencia Internacional 2018
Online Workshops “Teaching and Leadership According to The Urantia Book”	Talleres virtuales «Enseñanza y liderazgo según El libro de Urantia»
Gothenburg Book Fair – Sweden	Feria del Libro de Gotemburgo (Suecia)
Dancing with God: Emerging in Sacredness – A Retreat for Women	Bailar con Dios: Emerger en lo sagrado. Un retiro de mujeres en la Fundación Urantia
First National Meeting	Primera conferencia nacional de la Asociación Urantia de Perú
Items of Interest from the Website	Elementos de interés del sitio web
Global Member Survey 2018	Encuesta global de miembros 2018
2018	2018
Tidings — March 2018	Tidings — marzo 2018
Tidings — March 2018 — Content	Tidings — Noticias y actualizaciones de la IUA — marzo 2018
President’s Message – March 2018	Mensaje del presidente – marzo 2018
European Urantia Leadership Meeting	Reunión de líderes europeos
Subsites for Regional Urantia Associations	Subsitios para asociaciones Urantia
Jean Royer Graduation	Graduación de Jean Royer
Online Workshop Series Report	Informe sobre la serie de talleres virtuales
History of Study Groups	Historia de los grupos de estudio
Ministry in Belgium Prisons	Ministerio en las prisiones belgas
Finnish Winter Meeting 2018	Reunión finlandesa de invierno 2018
Miami Book Fair	Feria del Libro de Miami
Tidings — June 2018	Tidings — junio 2018
Tidings — June 2018 — Content	Tidings — Noticias y actualizaciones de la IUA — junio 2018
President’s Message – June 2018	Mensaje del presidente – junio 2018
International Conference 2018 Report	Informe sobre la Conferencia Internacional 2018
Reflections from 2018 International Conference	Reflexiones sobre la Conferencia Internacional 2018
Ghana Conference Report 2018	Informe de la Conferencia 2018 de Ghana
Urantia Young Adults Post-Conference	Posconferencia de la Urantia Young Adults
Urantia Association Educational Activities	Actividades educativas de la Asociación Urantia
We Have Modernized Urantia Association International	Hemos modernizado la Asociación Urantia Internacional
Latin American Conference 2018 in Brazil	Conferencia Latinoamericana 2018 en Brasil
2021 Urantia Association International Conference – Peru	Conferencia de la Asociación Urantia Internacional 2021 en Perú
Bogotá International Book Fair – 2018	Feria Internacional del Libro de Bogotá 2018
Spain National Meeting Report – 2018	Encuentro de lectores españoles 2018
Effective Study Groups	Grupos de estudio efectivos
Dutch Urantia Association Annual Conference	Conferencia anual de la Asociación Urantia holandesa
Tidings — September 2018	Tidings — septiembre 2018
Tidings — September 2018 — Content	Tidings — Noticias y actualizaciones de la IUA — septiembre 2018
President’s Message – September 2018	Mensaje del presidente – septiembre 2018
Farewell to Sue Tennant	Adiós a Sue Tennant
Finnish Summer Conference Report, 2018	Informe sobre la Conferencia de Verano finlandesa de 2018
Donating via AmazonSmile	Donar vía AmazonSmile
Why Do We Study The Urantia Book?	¿Por qué estudiamos El libro de Urantia?
2nd Latin American Conference — São Paulo, Brazil	II Conferencia Latinoamericana — São Paulo (Brasil)
ANZURA Conference Queensland 2018	Conferencia 2018 de ANZURA en Queensland
Testimonials from Book Fair Attendees	Testimonios de asistentes a ferias de libros
Tidings — December 2018	Tidings — diciembre 2018
Tidings — December 2018 — Content	Tidings — Noticias y actualizaciones de la IUA — diciembre 2018
President’s Message – December 2018 –	Mensaje del presidente – diciembre 2018
Latin American Youth Meeting – Brazil 2018 –	Reunión de jóvenes latinoamericanos – Brasil 2018
Italian-French Urantia Conference – Garda Lake, 2018 –	Conferencia Urantia francoitaliana – lago de Garda, 2018
Testimonials of Truth-Search, Growth and Service –	Testimonios de búsqueda de la verdad, crecimiento y servicio
Pereira Book Fair 2018 –	Feria del Libro de Pereira 2018
Cali International Book Fair 2018 –	Feria Internacional del Libro de Cali 2018
2nd European Urantia Conference – Tallinn, Estonia 2019 –	II Conferencia Urantia Europea – Tallin (Estonia) 2019
Conference & Chartering – Ecuador 2018 –	Conferencia y acreditación – Ecuador 2018
Advocacy for Study Groups –	Defensa de los grupos de estudio
2019	2019
Tidings — March 2019	Tidings — marzo 2019
Tidings — March 2019 — Content	Tidings — Noticias y actualizaciones de la IUA — marzo 2019
President’s Message – March 2019	Mensaje del presidente – marzo 2019
Dissemination Committee Update	Novedades del comité de Diseminación
ISB Elections	Elecciones a la JIS
More on Study Groups	Más sobre grupos de estudio
Update 2nd European Urantia Conference	Novedades de la II Conferencia Urantia Europea
Vancouver Canada 2020	Vancouver Canadá 2020
ANZURA Conference – Canberra 2019	Conferencia de ANZURA – Canberra 2019
Vancouver Island Campout	Acampada en la isla de Vancouver
Happy Birthday PIRT! 	¡Feliz cumpleaños, PIRT! 
Challenges and Loving Service Ministry in Venezuela	Retos y ministerio de servicio amoroso en Venezuela
Urantia Peru National Conference 2018	Conferencia Nacional Urantia 2018 de Perú
Women’s Meeting—Máncora, Peru	Reunión de mujeres en Máncora (Perú)
Helping the Revelation Succeed	Ayudar a que la revelación tenga éxito
Graduation of Richard Keeler	Graduación de Richard Keeler
Graduation of Eddie King	Graduación de Eddie King
Graduation of Ken Ingle	Graduación de Ken Ingle
Tidings — June 2019	Tidings — junio 2019
Tidings — June 2019 — Content	Tidings — Noticias y actualizaciones de la IUA — junio 2019
President’s Message – June 2019	Mensaje del presidente – junio 2019
Comments on the ISB Elections	Comentarios sobre las elecciones de la JIS
2nd European Conference in Tallinn – Last Reminder	II Conferencia Europea de Tallin, último recordatorio
Pre-Conference – 2nd European Conference in Tallinn	Preconferencia – II Conferencia Europea de Tallin
Post-Conference – 2nd European Conference	Posconferencia – II Conferencia Europea
Urantia Midwest Conference 2019	Conferencia Urantia del Medio Oeste 2019
Annual Retreat for UK and Ireland 2019	Retiro anual de Reino Unido e Irlanda 2019
Urantia Global Experience – Vancouver 2020	Experiencia Global Urantia – Vancouver 2020
Urantia Life Lessons	Lecciones de vida de Urantia
18th National Meeting of Readers in Spain	XVIII Encuentro de lectores del libro en España
The Parliament of the World’s Religions 2018	El Parlamento de las Religiones del Mundo 2018
Urantia in Medellín, Colombia	Urantia en Medellín (Colombia)
Farewell Moussa Ndiaye	Adiós a Moussa Ndiaye
Tidings — September 2019	Tidings — septiembre 2019
Tidings — September 2019 — Content	Tidings — Noticias y actualizaciones de la IUA — septiembre 2019
President’s Message – September 2019	Mensaje del presidente – septiembre 2019
2nd European Urantia Association Conference	II Conferencia Europea de la Asociación Urantia
Young Adults Pre-European Conference Retreat	Retiro preconferencia europea de jóvenes adultos
Feria del Libro de Bolivia 2019 – Santa Cruz	Feria del Libro de Bolivia 2019 – Santa Cruz
Ecuador Book Fair 2019	Feria del Libro de Ecuador 2019
Guatemala Book Fair	Feria del Libro de Guatemala
ANTFIL – an Alternative Fair in Peru	ANTIFIL – una feria alternativa en Perú
Farewell Mark Bloomfield	Despedida a Mark Bloomfield
Tidings — December 2019	Tidings — diciembre 2019
Tidings — December 2019 — Content	Tidings — Noticias y actualizaciones de la IUA — diciembre 2019
President’s Message – December 2019	Mensaje del presidente – diciembre 2019
Joe in South Lake Tahoe	Joe en South Lake Tahoe
An Exciting Service Opportunity	Una emocionante oportunidad de servir
Language Multi-Linguist Project	Proyecto de Aprendizaje de Idiomas y Multilingüistas
Incarcerated and Valued	Encarcelados y valorados
CALI International Book Fair 2019	Feria Internacional del Libro de CALI 2019
Bogota International Book Fair – Colombia 2019	Feria Internacional del Libro de Bogotá – Colombia 2019
Peru 2021 – International Conference Update	Perú 2021 – Novedades de la Conferencia Internacional
Florida Urantia Conference 2020	Conferencia Urantia de Florida 2020
Vancouver 2020 – Urantia Global Experience	Vancouver 2020 – Experiencia Mundial Urantia
Donating with AmazonSmile	Donar con AmazonSmile
2020	2020
Tidings — March 2020	Tidings — marzo 2020
Tidings — March 2020 — Content	Tidings — Noticias y actualizaciones de la IUA — marzo 2020
President’s Message – March 2020	Mensaje del presidente – marzo 2020
Urantia Book Study Group Directory	Directorio de Grupos de Estudio de El libro de Urantia
Vancouver 2020 Update	Novedades de Vancouver 2020
Peru 2021 International Conference – Registration Now Open	Inscripción abierta para la Conferencia Internacional de Perú 2021
Third National Conference in Mexico City	Tercer Congreso Nacional en Ciudad de México
Reports on Nigeria-Ghana Urantia Conference	Informes sobre la Conferencia Urantia de Nigeria y Ghana
Daughters of God Update	Novedades de las Hijas de Dios
Tidings — June 2020	Tidings — junio 2020
Tidings — June 2020 — Content	Tidings — Noticias y actualizaciones de la IUA — junio 2020
President’s Message – June 2020	Mensaje del presidente – junio 2020
First Urantia Book Conference of the Philippines	Primera conferencia de El libro de Urantia en Filipinas
The Urantia Book in the Philippines	El libro de Urantia en Filipinas
Virtual Study Groups and Conferences	Grupos de estudio y conferencias virtuales
Meditation Mantras for Adjuster Attunement	Mantras de meditación para sintonizar con el Ajustador
Urantia Hackathon 2020 — A Call for Team Volunteers	Urantia Hackatón 2020 — Llamada para voluntarios de equipo
African Continental Coordinator	Coordinador continental africano
Tidings — September 2020	Tidings — septiembre 2020
Tidings — September 2020 — Content	Tidings — Noticias y actualizaciones de la IUA — septiembre 2020
President’s Message – September 2020	Mensaje del presidente – septiembre 2020
Third 24-hour Urantiathon	Tercer Urantiatón de 24 horas
Marcelino Responds	Marcelino responde
Stranded in Patagonia	Varados en la Patagonia
Focus on the Father	Centrarse en el Padre
Tidings — December 2020	Tidings — diciembre 2020
Tidings — December 2020 — Content	Tidings — Noticias y actualizaciones de la IUA — diciembre 2020
President’s Message – December 2020	Mensaje del presidente – diciembre 2020
11th Urantia Association International Conference 2021 – A Virtual Experience	XI Conferencia de la Asociación Urantia Internacional 2021: una experiencia virtual
Urantia Belgian Group Celebrates Jesus’ Birthday	El grupo Urantia belga celebra el cumpleaños de Jesús
Urantia University Institute News	Noticias del Urantia University Institute
Focus on the Father—Going to God’s Place	Centrarnos en el Padre, ir a casa de Dios
Farewell Ed Owen	Despedida a Ed Owen
Farewell to Carolyn Kendall	Despedida a Carolyn Kendall
Dialogues with Sofia: A Novel to Introduce The Urantia Book Teachings	Diálogos con Sofía: una novela para presentar las enseñanzas de El libro de Urantia
2021	2021
Tidings — March 2021	Tidings — marzo 2021
Tidings — March 2021 — Content	Tidings — Noticias y actualizaciones de la IUA — marzo 2021
President’s Message – March 2021	Mensaje del presidente – marzo 2021
Update – 11th Urantia Association Conference – A Virtual Experience	Novedades de la XI Conferencia de la Asociación Urantia – Una experiencia virtual
Fourth 24-hour Urantiathon – Faith, Joy, and Peace	IV Urantiatón de 24 horas – Fe, Alegría y Paz
Iberoamerican Urantiathon	Urantiatón Iberoamericano
Spiritualizing Everyday Life	Espiritualizar la vida cotidiana
Dancing with God – Living in Love in Trying Times Online Retreat	Bailar con Dios – Retiro virtual «Vivir en amor en tiempos difíciles»
Focus on the Father – Stop Resisting	Céntrate en el Padre y no te resistas
Derivative Works – Novels by Rick Warren	Obras derivadas – Novelas de Rick Warren
International Service Board News	Noticias de la Junta Internacional de Servicio
Tidings — June 2021	Tidings — junio 2021
Tidings — June 2021 — Content	Tidings — Noticias y actualizaciones de la IUA — junio 2021
President’s Message – June 2021	Mensaje del presidente – junio 2021
2024 Urantia Association International Conference in USA	Conferencia de la Asociación Urantia Internacional 2024 en los EE.UU.
Report on Virtual International Conference	Informe sobre la Conferencia Internacional Virtual
Spiritual Value in the Peru Conference	Valor espiritual de la Conferencia de Perú
Two Sides of the Same Coin	Dos caras de la misma moneda
Focus on the Father – Thoughts	Centrarse en el Padre – pensamientos
Tidings — September 2021	Tidings — septiembre 2021
Tidings — September 2021 — Content	Tidings — Noticias y actualizaciones de la IUA — septiembre 2021
President’s Message – September 2021	Mensaje del presidente – septiembre 2021
24-hour Artists’ Urantiathon Report	24-hour Artists’ Urantiathon Report
A Fantastic Experience	Una experiencia fantástica
Science Symposium III	III Simposio Científico
Center for Unity	Centro para la Unidad
The Anxious Evolution of Urantia	La evolución inquieta de Urantia
Focus on the Father — Filling and Spilling	Centrarse en el Padre — Llenar y derramar
Tidings — December 2021	Tidings — diciembre 2021
Tidings — December 2021 — Content	Tidings — Noticias y actualizaciones de la IUA — diciembre 2021
President’s Message – December 2021	Mensaje del presidente – diciembre 2021
Reflections: Ibero-American Urantiathon – November 2021	Reflexiones sobre la Urantiatón Iberoamericana – noviembre 2021
2021 ANZURA Virtual Conference Report	Informe de la Conferencia Virtual 2021 de ANZURA
Hand in Hand with Urantia Book Internet School (UBIS)	De la mano de la Escuela de El libro de Urantia en Internet (UBIS)
The Meaning of Christmas	El significado de la Navidad
Video Part 4D: Ancient Orvonton, and a Young Cosmic Web	Vídeo Parte 4D: El antiguo Orvonton y una joven telaraña cósmica
The Jesus Museum and The Jesus Metaverse	El museo de Jesús y el Metaverso de Jesús
Irmeli Ivalo-Sjölie – Obituary	Irmeli Ivalo-Sjölie – Obituario
2022	2022
Tidings — March 2022	Tidings — marzo 2022
Tidings — March 2022 — Content	Número Especial de Tidings — Noticias y actualizaciones de la IUA — marzo 2022
Brazil Urantia Association	Asociación Urantia de Brasil
Senegal Urantia Association	Asociación Urantia de Senegal
Australia & New Zealand Urantia Association	Asociación Urantia de Australia y Nueva Zelanda
Guatemala Urantia Association	Asociación Urantia de Guatemala
GLMUA – New Membership Invitation	GLMUA – Nueva invitación a ser miembro
Belgium-Francophone Urantia Association	Asociación Urantia de la Bélgica francófona
Sweden Urantia Association	Asociación Urantia de Suecia
Online Education	Educación en línea
Other News – The Urantia Book Fellowship’s Education Committee	Otras noticias
Tidings — June 2022	Tidings — junio 2022
Tidings — June 2022 — Content	Número especial de Tidings — Noticias y actualizaciones de la IUA — junio 2022
Graduation of David Linthicum	Graduación de David Linthicum
Fearless Leader of PIRT — Ode to a Friend	Líder intrépido del PIRT — Oda a un amigo
Eulogy for David Linthicum	Elogio de David Linthicum
The Eyedropper, Spoon, and Shovel	El cuentagotas, la cuchara y la pala
Two Sides of the Same Coin	Dos caras de la misma moneda
Gallery for David	Galería de David
Tidings — September 2022	Tidings — septiembre 2022
Tidings — September 2022 — Content	Tidings — Noticias y actualizaciones de la IUA — septiembre 2022
President’s Message – September 2022	Mensaje del presidente – septiembre 2022 
3rd European Urantia Conference 2022	III Conferencia Urantia Europea 2022
Prison Inmate Response Team (PIRT) Mission Statement 	Declaración de misión del Equipo de Respuesta a Peticiones de Reclusos (PIRT)
The Jesus Metaverse	El Metaverso de Jesús
I Found the Key	Encontré la clave
The Urantia Uganda Conference 2022	La Conferencia Urantia de Uganda 2022
Parliament of the World’s Religions	Parlamento de las Religiones del Mundo
Tidings — December 2022	Tidings — diciembre 2022
Tidings — December 2022 — Content	Tidings — Noticias y actualizaciones de la IUA — diciembre 2022
President’s Message – December 2022	Mensaje del presidente – diciembre 2022
A Study Group As a Circle of Trust	Los grupos de estudio como círculos de confianza
3rd European Conference of Urantia Book Readers	III Conferencia Europea de Lectores de El libro de Urantia
Farewell Margo Sherwood	Despedida a Margo Sherwood
2023	2023
Tidings — March 2023	Tidings — marzo 2023
Tidings — March 2023 — Content	Tidings — Noticias y actualizaciones de la IUA — marzo 2023
President’s Message – March 2023	Mensaje del presidente – marzo 2023
Latin American Continental Conference — Mexico	Conferencia Continental Latinoamericana — México
A Special Youth Urantiathon	Un Urantiatón Juvenil especial
Love for the Father	El amor por el Padre
Focus on the Father	Centrarse en el Padre
Progressive Divine Wisdom	Sabiduría divina progresiva
Urantia Book Learning Centers	Centros de aprendizaje de El libro de Urantia
Great Britain & Ireland Annual Summer Retreat 2023	Retiro anual de verano de Gran Bretaña e Irlanda 2023
Soul Evolution Study Aid	Ayuda al estudio «Evolución del alma»
My Journeys with Jesus—Video	Mis viajes con Jesús—vídeo
Tidings — June 2023	Tidings — junio 2023
Tidings — June 2023 — Content	Tidings — Noticias y actualizaciones de la IUA — junio 2023
President’s Message – June 2023	Mensaje del presidente – junio 2023
The Unexpected Jewel: A PIRT Report	La joya inesperada: informe del PIRT
Focus on the Father	Centrarse en el Padre
The God Experience	The God Experience (La experiencia de Dios)
Savor Friendship: A Tribute to Delae Sowu (1962 – 2023)	El sabor de la amistad: homenaje a Delae Sowu (1962 – 2023)
Tidings — September 2023	Tidings — septiembre 2023
Tidings — September 2023 — Content	Tidings — Noticias y actualizaciones de la IUA — septiembre 2023
President’s Message – September 2023	Mensaje del presidente – septiembre 2023
Latin American Continental Conference — Mexico	Conferencia Continental Latinoamericana — México
Urantia Book Study Group at Oregon State Penitentiary	Grupo de estudio de El libro de Urantia en el Centro Penitenciario del Estado de Oregón
Focus on the Mother	Centrarse en la Madre
Reflections on the Parliament of the World’s Religions, Chicago 2023	Reflexiones sobre el Parlamento de las Religiones del Mundo, Chicago 2023
Tidings — December 2023	Tidings — Diciembre 2023
Tidings — December 2023 — Content	Tidings — Noticias y actualizaciones de la IUA — Septiembre 2023
President’s Message – December 2023	Mensaje del presidente – diciembre 2023
2024 Urantia Association International Conference Update	Noticias de la Conferencia 2024 de la Asociación Urantia Internacional
2023 ANZURA Annual Conference Report	Informe de la Conferencia anual 2023 de ANZURA
Third Latin American Conference Report	Informe sobre la III Conferencia Latinoamericana
Focus on the Father – Spiritual Gifts	Centrarse en el Padre – Regalos espirituales
The Mission of the Prisoner Inquiry Response Team	La misión del Equipo de Respuesta a Peticiones de Reclusos
Update to the Urantia Association Bylaws	Actualización de los Reglamentos de la Asociación Urantia
2024	2024
Tidings — March 2024	Tidings — Marzo 2024
Tidings — March 2024 — Content	Tidings — Noticias y actualizaciones de la IUA — Marzo 2024
President’s Message – March 2024	Mensaje del presidente – marzo 2024
The 2024 Urantia Association International Conference Approaches	Se acerca la Conferencia 2024 de la Asociación Urantia Internacional
New Unity Initiative	Nueva iniciativa de unidad
Focus on the Father – Faith	Centrarse en el Padre: la fe
Slow and Steady	Lento y seguro
Urantia Book Teacher Education Program	Programa de Formación de Profesores de El libro de Urantia
Tidings — June 2024	Tidings — Junio 2024
Tidings — June 2024 — Content	Tidings — Noticias y actualizaciones de la IUA — Junio 2024
President’s Message	Mensaje del presidente
The Importance of Organizational Unity	La importancia de la unidad organizativa
Update on Unity Initiative	Novedades de la Iniciativa de Unidad
Retrospective on the 2024 International Conference	Retrospectiva de la Conferencia Internacional 2024
Baltimore Children and Teen Program	Programa para Niños y Adolescentes de Baltimore
Announcing Two New Programs	Anuncio de dos nuevos programas
Fourth European Conference, Paris	IV Conferencia Europea, París
ANZURA Conference 2024 – Melbourne	Conferencia 2024 de ANZURA