Index of “Le Lien”, French Urantia Association Journal	Índice de “Le Lien”, revista francesa de la Asociación Urantia
1996	1996
Le Lien Urantien — Issue 1 — Summer 1996	Le Lien Urantien — Número 1 — Verano 1996
Le Lien Urantien — Issue 1 — Summer 1996 — Contents	Le Lien Urantien — Número 1 — Verano de 1996
A short story about personality	Una pequeña historia sobre la personalidad.
Infallible cosmic compass	Brújula cósmica infalible
Reflection: They tell us...	Reflexión: Nos dicen...
The Adjuster according to C.G. Jung	El Ajustador según C.G. Jung
When a little peace descends upon us	Cuando un poco de paz desciende sobre nosotros
Urantia on the Internet	Urantia en Internet
Le Lien Urantien — Issue 2 — Autumn 1996	Le Lien Urantien — Número 2 — Otoño 1996
Le Lien Urantien — Issue 2 — Autumn 1996 — Contents	Le Lien Urantien — Número 2 — Otoño de 1996
Artistic conception of the Master Universe	Concepción artística del Universo Maestro
Report of the 3rd International Conference of Associations Affiliated to the I.U.A.	Informe de la 3ª Conferencia Internacional de Asociaciones Afiliadas a la I.U.A.
Meeting of the translators of the URANTIA Book organized by the URANTIA Foundation in PARIS in April 1996	Reunión de traductores del Libro de URANTIA organizada por la Fundación UrANTIA en PARÍS en abril de 1996
The Consecration	La Consagración
Le Lien Urantien — Issue 3 — Winter 1996	Le Lien Urantien — Número 3 — Invierno 1996
Le Lien Urantien — Issue 3 — Winter 1996 — Contents	Le Lien Urantien — Número 3 — Invierno de 1996
Artistic conception of the Master Universe (2) Artistic conception of the Master Universe (2)	Concepción artística del Universo Maestro (2)
The Personality	Personalidad
Bruno Bettelheim and our anguished era	Bruno Bettelheim y nuestros tiempos de ansiedad
1997	1997
Le Lien Urantien — Issue 4 — Summer 1997	Le Lien Urantien — Número 4 — Verano 1997
Le Lien Urantien — Issue 4 — Summer 1997 — Contents	Le Lien Urantien — Número 4 — Verano de 1997
The American justice system rules in favor of copyright on appeal	La justicia estadounidense falla en apelación a favor de los derechos de autor
After death	Despues de la muerte
Deity and divinity	Deidad y divinidad
The Personality (2)	Personalidad (2)
Supremacy	Supremacía
Le Lien Urantien — Issue 5 — Autumn 1997	Le Lien Urantien — Número 5 — Otoño 1997
Le Lien Urantien — Issue 5 — Autumn 1997 — Contents	Le Lien Urantien — Número 5 — Otoño de 1997
International Conference of the I.U.A. in Helsinki from August 7 to 10, 1998	Congreso Internacional de la I.U.A. en Helsinki del 7 al 10 de agosto de 1998
Meeting of September 21, 1997 in Villebon-Sur-Yvette	Reunión del 21 de septiembre de 1997 en Villebon-Sur-Yvette
Metaphysical Thoughts of an Agnostic	Pensamientos metafísicos de un agnóstico
Coherence, or Principle of Evanescence?	¿Coherencia o principio de evanescencia?
The Spirit of Truth: Unifying Pole of Religions?	El Espíritu de la Verdad: ¿polo unificador de las religiones?
Personality, Identity, Divinity	Personalidad, Identidad, Divinidad
1998	1998
Le Lien Urantien — Issue 6 — Summer 1998	Le Lien Urantien — Número 6 — Verano 1998
Le Lien Urantien — Issue 6 — Summer 1998 — Contents	Le Lien Urantien — Número 6 — Verano de 1998
Awaiting the Resurrection	Esperando la resurrección
Contribution to Jean Royer's article “Coherence, or principle of evanescence?” from Lien n5	Contribución al artículo de Jean Royer “¿Coherencia o principio de evanescencia? » del enlace n5
Le Lien Urantien — Issue 7 — Autumn 1998	Le Lien Urantien — Número 7 — Otoño 1998
Le Lien Urantien — Issue 7 — Autumn 1998 — Contents	Le Lien Urantien — Número 7 — Otoño de 1998
The Urantia Book and Children	El libro de Urantia y los niños
Emergence and Finality of Worship	Surgimiento y propósito de la adoración
IUA Conference Reports	Informe de las conferencias de la IUA
Le Lien Urantien — Issue 8 — Winter 1998	Le Lien Urantien — Número 8 — Invierno 1998
Le Lien Urantien — Issue 8 — Winter 1998 — Contents	Le Lien Urantien — Número 8 — Invierno de 1998
The Intelligence of the Heart	Inteligencia del corazón
What is What Happens After Death?	¿Qué pasa después de la muerte?
Absolutes and Reality	Absolutos y realidad
1999	1999
Le Lien Urantien — Issue 9 — Spring 1999	Le Lien Urantien — Número 9 — Primavera 1999
Le Lien Urantien — Issue 9 — Spring 1999 — Contents	Le Lien Urantien — Número 9 — Primavera de 1999
Cooperation with the Adjuster	Cooperación con el Ajustador
Who Was Jesus?	¿Quién era Jesús?
The Three Great Human Experiences	Las tres grandes experiencias del ser humano
Trinitization	Trinitización
The Seven Circuits of Havona	Los siete circuitos de Havona
Le Lien Urantien — Issue 10 — Summer 1999	Le Lien Urantien — Número 10 — Verano 1999
Le Lien Urantien — Issue 10 — Summer 1999 — Contents	Le Lien Urantien — Número 10 — Verano de 1999
The Identification Process	El proceso de identificación
The Evolution of Fetishism and Idols “Sacred Books”	La evolución del fetichismo y los ídolos “libros sagrados”
Who Was Jesus? (Part 2)	¿Quién era Jesús? (2da parte)
Reflections on the Jesus Prayer	Reflexiones sobre la oración de Jesús
Joseph’s Death and Destiny	La muerte y el destino de José.
Le Lien Urantien — Issue 11 — Autumn 1999	Le Lien Urantien — Número 11 — Otoño 1999
Le Lien Urantien — Issue 11 — Autumn 1999 — Contents	Le Lien Urantien — Número 11 — Otoño de 1999
The Urantia Book in Africa	El libro de Urantia en África
Who Was Jesus? (end)	¿Quién era Jesús? (FIN)
Facts, Meanings, and Values	Hechos, significados y valores
Poem…	Poema…
Le Lien Urantien — Issue 12 — Winter 1999	Le Lien Urantien — Número 12 — Invierno 1999
Le Lien Urantien — Issue 12 — Winter 1999 — Contents	Le Lien Urantien — Número 12 — Invierno de 1999
“About” the Apostle Paul	“Acerca” del apóstol Pablo
The Decision Center	El centro de decisiones
My Adjuster and I	Mi Ajustador y yo
2000	2000
Le Lien Urantien — Issue 13 — Spring 2000	Le Lien Urantien — Número 13 — Primavera 2000
Le Lien Urantien — Issue 13 — Spring 2000 — Contents	Le Lien Urantien — Número 13 — Primavera de 2000
A fire	Un incendio
Melchizedek or the 2nd Revelation	Melquisedec o la 2da Revelación
Does God exist?	¿Existe Dios?
What Would Jesus do ?	“¿Qué haría Jesús?”
Le Lien Urantien — Issue 14 — Summer 2000	Le Lien Urantien — Número 14 — Verano 2000
Le Lien Urantien — Issue 14 — Summer 2000 — Contents	Le Lien Urantien — Número 14 — Verano de 2000
Variations around a Center of Gravity	Variaciones alrededor de un centro de gravedad
The Dual Nature of Supremacy	La naturaleza dual de la supremacía
Reflections on the Jesus Prayer (2)	Reflexiones sobre la Oración de Jesús (2)
The Mystery of the Maries	El misterio de las Marías
Le Lien Urantien — Issue 15 — Autumn 2000	Le Lien Urantien — Número 15 — Otoño 2000
Le Lien Urantien — Issue 15 — Autumn 2000 — Contents	Le Lien Urantien — Número 15 - Otoño de 2000
The Animal Mind	La mente animal
A Small, Well-Filled Bottle	Botella pequeña llena
Supreme Rant-ings	Desvaríos supremos
International Meeting of 2002 Progress Report No. 3	2002 Encuentro Internacional Avance No. 3
Report of the CNP Meeting in New York on August 2, 2000	Acta de la reunión del CNP en Nueva York el 2 de agosto de 2000
Le Lien Urantien — Issue 16 — Winter 2000	Le Lien Urantien — Número 16 — Invierno 2000
Le Lien Urantien — Issue 16 — Winter 2000 — Contents	Le Lien Urantien — Número 16 — Invierno de 2000
The Facets of Truth	Facetas de la verdad
UB Readers' Meeting	Reunión de lectores de LU
The Contraction of Space-Time	La contracción del espacio-tiempo
Proposals and Reflections on the 2002 Meeting	Propuestas y reflexiones sobre la reunión de 2002
2001	2001
Le Lien Urantien — Issue 17 — Spring 2001	Le Lien Urantien — Número 17 — Primavera 2001
Le Lien Urantien — Issue 17 — Spring 2001 — Contents	Le Lien Urantien — Número 17 — Primavera de 2001
Democracy	Democracia
Living Our Father's Will: A Daily Experience	Vivir la voluntad de nuestro Padre: una experiencia diaria
Good Behavior	Buen comportamiento
Relaxation Corner: The Mason and the Great Architect	Rincón de relajación: El albañil y el gran arquitecto
Regain	Recuperar
The Text of “Treasure” Explained	El texto del “Tesoro” explicado
To My Immortal Soul	A mi alma inmortal
Gazette Section: At the Mother House	Sección del boletín: En la empresa matriz
The Little Bottle Is Still Filling Up	La botellita todavía se está llenando.
Le Lien Urantien — Issue 18 — Summer 2001	Le Lien Urantien — Número 18 — Verano 2001
Le Lien Urantien — Issue 18 — Summer 2001 — Contents	Le Lien Urantien — Número 18 - Verano de 2001
Brief reflection on the mind	Breve reflexión sobre la mente
The role of emotions in spiritual research	El papel de las emociones en la búsqueda espiritual
Truth and lies or Facts and falsehood	Verdad y mentiras o Hechos y falsedades
Relaxation corner: Impressions of the future	Rincón de relajación: impresiones del futuro
The angel	El angel
After the meeting of May 2001 at N. D. des Lumiêres	Después de la reunión de mayo de 2001 en N. D. des Lumiêres
Le Lien Urantien — Issue 19 — Autumn 2001	Le Lien Urantien — Número 19 — Otoño 2001
Le Lien Urantien — Issue 19 — Autumn 2001 — Contents	Le Lien Urantien — Número 19 — Otoño de 2001
Anova (Part One)	Ánova (primera parte)
The Power to Choose	El poder de elegir
The Supreme, God the Sevenfold, Forces, Energies and Universal Control of Power: 100 Questions and Answers (1)	El Supremo, Dios Séptuplo, Fuerzas, Energías y Control Universal del Poder: 100 Preguntas y Respuestas (1)
Art and Testimonies	Arte y testimonios
Relaxation Corner Poem	Poema rincón de relajación
Le Lien Urantien — Issue 20 — Winter 2000	Le Lien Urantien — Número 20 — Invierno 2000
Le Lien Urantien — Issue 20 — Winter 2000 — Contents	Le Lien Urantien — Número 20 - Invierno de 2001
Life	La vida
Anova (Part Two)	Anova (segunda parte)
There are the Urantian Years and...	Están los años urantianos y...
The Supreme, God the Sevenfold, Forces, Energies and Universal Power Control: 100 Questions and Answers (2)	El Supremo, Dios Séptuplo, Fuerzas, Energías y Control Universal del Poder: 100 Preguntas y Respuestas (2)
Art and Testimonies	Arte y testimonios
2002	2002
Le Lien Urantien — Issue 21 — Spring 2002	Le Lien Urantien — Número 21 — Primavera 2002
Le Lien Urantien — Issue 21 — Spring 2002 — Contents	Le Lien Urantien — Número 21 — Primavera de 2002
The Fourth Age	La cuarta edad
Joy	Alegría
Freedom	Libertad
A Glimpse of the General Organization of the Master Universe and Theory of Totality by the Researchers of Uversa	Una mirada a la organización general del Universo Maestro y la teoría de la totalidad por investigadores de Uversa
Should a New Church Be Founded?	¿Deberíamos fundar una nueva iglesia?
Rotation	Rotación
Full Line from the Most High	Línea continua desde arriba
Le Lien Urantien — Issue 22 — Summer 2002	Le Lien Urantien — Número 22 — Verano 2002
Le Lien Urantien — Issue 22 — Summer 2002 — Contents	Le Lien Urantien — Número 22 — Verano de 2002
Reality Synthesis	Resumen de la realidad
Life Carriers	Portadores de vida
Teamwork	Trabajo en equipo
Seasons	Estaciones
Le Lien Urantien — Issue 23 — Autumn 2002	Le Lien Urantien — Número 23 — Otoño 2002
Le Lien Urantien — Issue 23 — Autumn 2002 — Contents	El vínculo urantiano – Número 23 – Otoño de 2002
Missions	Misiones
Does Man Need God to Live? Is It Weakness to Believe in God?	¿Necesita el hombre a Dios para vivir? ¿Es debilidad creer en Dios?
The Directors of the Census	Directores del Censo
Dalamatia, the City of the Hundreds of Caligastia, Dilmun, the City of the Nodites	Dalamatia, la ciudad de los cientos de Caligastia, Dilmun, la ciudad de los noditas
Retreats	Jubilaciones
Poem for Jesus	Poema para Jesús
Clarity	Claridad
August in Dourdan	Agosto en Dourdan
Le Lien Urantien — Issue 24 — Winter 2002	Le Lien Urantien — Número 24 — Invierno 2002
Le Lien Urantien — Issue 24 — Winter 2002 — Contents	Le Lien Urantien — Número 24 — Invierno de 2002
The Personality	Personalidad
If...	Si...
The Providence of God	La providencia de Dios
Sudden Awakening	Despertar repentino
2003	2003
Le Lien Urantien — Issue 25 — Spring 2003	Le Lien Urantien — Número 25 — Primavera 2003
Le Lien Urantien — Issue 25 — Spring 2003 — Contents	Le Lien Urantien — Número 25 — Primavera de 2003
Approaching some scientific aspects of The Urantia Book	Aproximación a algunos aspectos científicos del Libro de Urantia
Ignorance	Ignorancia
Story of a visit	Historia de una visita
Sudden awakening (second part)	Despertar repentino (segunda parte)
Words of love	Palabras de amor
Le Lien Urantien — Issue 26 — Summer 2003	Le Lien Urantien — Número 26 — Verano 2003
Le Lien Urantien — Issue 26 — Summer 2003 — Contents	Le Lien Urantien — Número 26 — Verano de 2003
Material Time — Morontia Time — Spiritual Time - “The Importance of Time According to The Urantia Book”	Tiempo material – tiempo morontial – tiempo espiritual – “la importancia del tiempo según el Libro de Urantia”
A Little Personal Theory on the Proof of God's Existence	Una pequeña teoría personal sobre la prueba de la existencia de Dios.
First Meeting. Story of a Visit	Primera reunión. Historia de una visita
“The Will of God”: Elucubration or God, My Best Friend?!	“La voluntad de Dios”: ¡¿despotricar o Dios, mi mejor amigo?!
Le Lien Urantien — Issue 27 — Autumn 2003	Le Lien Urantien — Número 27 — Otoño 2003
Le Lien Urantien — Issue 27 — Autumn 2003 — Contents	Le Lien Urantien — Número 27 — Otoño de 2003
Material Time — Morontia Time — Spiritual Time - “The Importance of Time According to The Urantia Book” (2)	Tiempo material - tiempo morontial - tiempo espiritual - la importancia del tiempo según el Libro de Urantia (2)
The Hidden Version of Part IV of The Urantia Book	La versión oculta de la cuarta parte del Libro de Urantia
Reincarnation, Truth or Superstition?	Reencarnación, ¿verdad o superstición?
Doubt and Doubts	Dudas y dudas
Doubt	Duda
August 21, 2003	21 de agosto de 2003
Le Lien Urantien — Issue 28 — Winter 2003	Le Lien Urantien — Número 28 — Invierno 2003
Le Lien Urantien — Issue 28 — Winter 2003 — Contents	Le Lien Urantien — Número 28 - Invierno de 2003
Carolyn Kendall talks about history the Time factor	Carolyn Kendall habla de historia The Time Postman
The art of living — according to Jesus and the Urantia Book	El arte de vivir: según Jesús y el libro de Urantia
The 100 Factor or the 757,575 years that separate us (maybe) from Paradise	El Factor 100 o los 757.575 años que nos separan (quizás) del Paraíso
Humor, laughter and smiles in the Urantia Book	Humor, risas y sonrisas en el Libro de Urantia
Report of the Armeau meeting: November 2003	Informe de la reunión de Armeau: noviembre de 2003
Relaxation corner: I am no longer afraid	Zona de relajación: Ya no tengo miedo
Testimony	Testimonio
2004	2004
Le Lien Urantien — Issue 29 — Spring 2004	Le Lien Urantien — Número 29 — Primavera 2004
Le Lien Urantien — Issue 29 — Spring 2004 — Contents	Le Lien Urantien — Número 29 — Primavera de 2004
What are “black holes”?	¿Qué son los “agujeros negros”?
Triptych	Tríptico
Reflections	Pensamientos
Should we juggle with numbers?	¿Deberíamos hacer malabarismos con los números?
For a friend	Para un amigo
Other eyes, other skies...	Otros ojos, otros cielos...
A life must die	Una vida debe morir
Love dissolves differences...	El amor disuelve las diferencias...
Le Lien Urantien — Issue 30 — Summer 2004	Le Lien Urantien — Número 30 — Verano 2004
Le Lien Urantien — Issue 30 — Summer 2004 — Contents	Le Lien Urantien — Número 30 — Verano de 2004
The great challenge	El gran desafío
Beauty	Belleza
From matter to Spirit via the mind	De la materia al Espíritu vía la mente
Sharing The Urantia Book with young teens.	Compartiendo el Libro de Urantia con jóvenes adolescentes.
Form and Resurrection	Forma y resurrección
Le Lien Urantien — Issue 31 — Autumn 2004	Le Lien Urantien — Número 31 — Otoño 2004
Le Lien Urantien — Issue 31 — Autumn 2004 — Contents	Le Lien Urantien — Número 31 - Otoño de 2004
Cosmic Consciousness	Conciencia Cósmica
Discernment and Free Will	Discernimiento y libre albedrío
Bridges, walkways and rope ladders	Puentes, pasarelas y escaleras de cuerda.
Nostalgia	Nostalgia
Magic	Magia
Le Lien Urantien — Issue 32 — Winter 2004	Le Lien Urantien — Número 32 — Invierno 2004
Le Lien Urantien — Issue 32 — Winter 2004 — Contents	Le Lien Urantien — Número 32 — Invierno de 2004
Becoming What I AM	Conviértete en lo que SOY
Reason and Faith	Razón y fe
Hasty Judgment	Juicio apresurado
Where Metaphysics Totally Fails	Donde la metafísica falla totalmente
Testimony: Diamond Wedding or Smiling Philosophy of Serene Octogenarians	Testimonio: Bodas de Diamante o la filosofía sonriente de octogenarios serenos
Absence	Ausencia
2005	2005
Le Lien Urantien — Issue 33 — Spring 2005	Le Lien Urantien — Número 33 — Primavera 2005
Le Lien Urantien — Issue 33 — Spring 2005 — Contents	Le Lien Urantien — Número 33 — Primavera de 2005
Proposal of a reading method	Propuesta de método de lectura
The friend of God	Amigo de dios
The search for God is the search for his three values: truth beauty goodness	La búsqueda de Dios es la búsqueda de sus tres valores: verdad, belleza y bondad.
Thought	Pensamiento
Le Lien Urantien — Issue 34 — Summer 2005	Le Lien Urantien — Número 34 — Verano 2005
Le Lien Urantien — Issue 34 — Summer 2005 — Contents	Le Lien Urantien — Número 34 — Verano de 2005
Contact	Contacto
Theoretical Explanation of Creation	Explicación teórica de la creación.
God the Absolute	Dios el absoluto
Pentecost of the Year 30: Forty or Fifty Days After Easter?	Pentecostés del año 30: ¿cuarenta o cincuenta días después de Pascua?
The Impossible Dialogue with Fundamentalists	El diálogo imposible con los fundamentalistas
Le Lien Urantien — Issue 35 — Autumn/Winter 2005	Le Lien Urantien — Número 35 — Otoño/Invierno $2
Le Lien Urantien — Issue 35 — Autumn/Winter 2005 — Contents	Le Lien Urantien — Número 35 - Otoño/Invierno de 2005
Understanding your neighbor	Entendiendo a tu prójimo
Science, philosophy, religion and revelation	Ciencia, filosofía, religión y revelación.
From matter to spirit via the mind	De la materia al espíritu a través de la mente
For a friend	Para un amigo
Serenity	Serenidad
2006	2006
Le Lien Urantien — Issue 36 — Spring 2006	Le Lien Urantien — Número 36 — Primavera 2006
Le Lien Urantien — Issue 36 — Spring 2006 — Contents	Le Lien Urantien — Número 36 — Primavera de 2006
Spiritual Attraction	Atracción espiritual
The Trinity	La Santísima Trinidad
The Urantia Movement	El movimiento urantiano
Spiritual Sovereignty	Soberanía espiritual
Who Am I? — Where Do We Come From? — Where Are We Going? What Is the Purpose of Life?	¿Quién soy yo? —¿De dónde venimos? — ¿Adónde vamos? ¿Cuál es el propósito de la vida?
Le Lien Urantien — Issue 37 — Autumn 2006	Le Lien Urantien — Número 37 — Otoño 2006
Le Lien Urantien — Issue 37 — Autum 2006 — Contents	Le Lien Urantien — Número 37 - Otoño de 2006
The President's Word	Una palabra del presidente
Knowledge and Truth	Conocimiento y verdad
Dual Nature	Naturaleza dual
General Semantics and The Urantia Book	La semántica general y el libro de Urantia
“Faith”	Fe
ME!	¡A MÍ!
When He Passed By	Cuando pasó
The Game of “I Find Myself”	El juego del “me encuentro”
Report of the Meeting at the Grand Seminary of Lorraine	Informe de la reunión en el Gran Seminario de Lorena
Le Lien Urantien — Issue 38 — Hiver 2006	Le Lien Urantien — Número 38 — Invierno 2006
Le Lien Urantien — Issue 38 — Hiver 2006 — Contents	Le Lien Urantien — Número 38 - Invierno de 2006
The President's Word	Una palabra del presidente
Essays to explain the concept of living truth	Intentos de explicar el concepto de verdad viva.
Humans and their double	El humano y su doble
Worship God? An invitation to travel outside of space-time	¿Adorar a Dios? una invitación a viajar fuera del espacio-tiempo
A Reader's Experience, an experience to draw from	La experiencia de un lector, una experiencia de la que aprender
Testimony on the meeting in Armeau	Testimonio sobre el encuentro de Armeau
Sharing on spiritual teachings and leaders	Compartiendo enseñanzas y líderes espirituales
Report of the Armeau meeting	Informe de la reunión de Armeau
2007	2007
Le Lien Urantien — Issue 39 — Summer 2007	Le Lien Urantien — Número 39 — Verano 2007
Le Lien Urantien — Issue 39 — Summer 2007 — Contents	Le Lien Urantien — Número 39 — Verano de 2007
A Word from the President	Una palabra del presidente
Spiritual Wisdom and Genetic Knowledge	Sabiduría espiritual y conocimiento genético.
Brother Dominique's Corner	El rincón del hermano Dominique
Genese	Génesis
The Tulip	El tulipán
The Story of Life	La historia de la vida.
Memories Memories	Recuerdos Recuerdos
Annual Meeting at Notre Dame des Lumières	Reunión anual en Notre Dame des Lumières
Reflections from Georges & Marlene	Reflexiones de Georges y Marlene
Le Lien Urantien — Issue 40 — Autumn 2007	Le Lien Urantien — Número 40 — Otoño 2007
Le Lien Urantien — Issue 40 — Autum 2007 — Contents	Le Lien Urantien — Número 40 - Otoño de 2007
The President's Word	Una palabra del presidente
The Biological Improvement of Humanity	La mejora biológica de la humanidad.
Some Thoughts and Questions of Me	Algunos pensamientos y preguntas sobre mí
After the Death of His Life Companion	Tras la muerte de su compañero de vida
Thank You, My God	Gracias dios
Brother Dominique's Corner	El rincón del hermano Dominique
Michael's Birthday of August 21, 2007	Cumpleaños de Micaël el 21 de agosto de 2007.
Little Morontia Bubbles	Pequeñas burbujas morontiales
Urantia Book Study Group June 1979 — Letter No. 2	Grupo de Estudio del Libro de Urantia, junio de 1979 — Carta nº 2
Le Lien Urantien — Issue 41 — Hiver 2007	Le Lien Urantien — Número 41 — Invierno 2007
Le Lien Urantien — Issue 41 — Hiver 2007 — Contents	Le Lien Urantien — Número 41 — Invierno de 2007
The President's Word	Una palabra del presidente
Presentation of the Book	Presentación del libro
A Little Reflection on the Power of Loving (Part 1)	Una pequeña reflexión sobre el poder de amar (parte 1)
Story: The Barn	Cuento: El granero
AFLLU Autumn Meeting in AIX-LES-BAINS	Reunión de otoño de la AFLLU en AIX-LES-BAINS
Reflection on Infidelity	Reflexión sobre la infidelidad
Trinity of Supremacy	Trinidad de supremacía
Brother Dominique's Corner	El rincón del hermano Dominique
Georges & Marlène's Thoughts	Reflexiones de Georges y Marlène
2008	2008
Le Lien Urantien — Issue 42 — Spring 2008	Le Lien Urantien — Número 42 — Primavera 2008
Le Lien Urantien — Issue 42 — Spring 2008 — Contents	Le Lien Urantien — Número 42 — Primavera de 2008
The President's Word	Una palabra del presidente
Presentation of the Book	Presentación del libro
A Little Reflection on the Power of Loving (Part 2)	Una pequeña reflexión sobre el poder de amar (parte 2)
The 7 Jubilees	Los 7 jubileos
The Book and its Sources	El Libro y sus fuentes
The Winter Wind	El viento de invierno
The Essentials	Lo esencial
Brother Dominique's Corner	El rincón del hermano Dominique
Le Lien Urantien — Issue 43 — Summer 2008	Le Lien Urantien — Número 43 — Verano 2008
Le Lien Urantien — Issue 43 — Summer 2008 — Contents	Le Lien Urantien — Número 43 — Verano de 2008
Prelude: The President's Word	Preludio: Unas palabras del Presidente
Editorial	Editorial
Le Point: Dinard	El punto: Dinard
National Meeting from May 22 to May 25	Encuentro nacional del 22 al 25 de mayo
Study: Agondontarians	Estudio: Agondoncia
On the feeling of existing	Sobre el sentimiento de existir
Le Lien Urantien — Issue 44 — Autumn 2008	Le Lien Urantien — Número 44 — Otoño 2008
Le Lien Urantien — Issue 44 — Autum 2008 — Contents	Le Lien Urantien — Número 44 — Verano de 2008
The Guest	El invitado
Spring: Study of the Future	Primavera: estudio del futuro
Words of Life	Palabras de vida
How Beautiful You Have Made the Earth!	¡Qué hermosa has hecho la tierra!
Messenger Molecules	Moléculas mensajeras
Le Lien Urantien — Issue 45 — Winter 2008	Le Lien Urantien — Número 45 — Invierno 2008
Le Lien Urantien — Issue 45 — Winter 2008 — Contents	Le Lien Urantien — Número 45 — Verano de 2008
Editorial: It is written!	Editorial: ¡Está escrito!
Appellations of the Mystery Monitor	Nombres del Monitor Misterioso
The guest	El invitado
How big is Paradise	¿Qué tan grande es el paraíso?
The Self and the Ego	El yo y el ego
The Parable of the Oyster	La parábola de la ostra
Suresnes 21-23 November 08	Suresnes 21-23 noviembre 08
Strands of Life	Hilos de vida
A day in Suresnes	Un día en Suresnes
Other Sheep	Otras ovejas
In the spiritual life	En la vida espiritual
2009	2009
Le Lien Urantien — Issue 46 — Spring 2009	Le Lien Urantien — Número 46 — Primavera 2009
Le Lien Urantien — Issue 46 — Spring 2009 — Contents	Le Lien Urantien — Número 46 - Primavera de 2009
The President's Note	La nota del presidente
Guest: Dutch Urantia Association	Invitado: Asociación Urantia Holandesa
Levels of Realization	Niveles de logro
Personal Growth - Arrival Mansion Worlds	Crecimiento Personal - Arrival Worlds Houses
The Ego and the Self	El ego y el yo
Guten Tag Urantia!	¡Guten Tag Urantia!
Make Yourself	Tú
Blue Eyes	Ojos azules
Get Your Calculators	En tus calculadoras
Self-Healing	Autosanación
Brother Dominique's Little Corner	El pequeño rincón del hermano Dominique
Le Lien Urantien — Issue 47 — Summer 2009	Le Lien Urantien — Número 47 — Verano 2009
Le Lien Urantien — Issue 47 — Summer 2009 — Contents	Le Lien Urantien — Número 47 — Verano de 2009
The President's Note	La nota del presidente
Guest: Chilean Urantia Association	Invitado: Asociación Urantia de Chile
Human Philosophy and Mota	Filosofía humana y mota.
Meeting of 21.02.09	Reunión del 21.02.09
Tolerance	Tolerancia
Of the Word	De la palabra
Love	Amar
Having Wheat	Tener trigo
A Thousand Thanks	Muchas gracias
Doing the Father's Will	Haz la voluntad del Padre
Brother Dominique's Little Corner	El pequeño rincón del hermano Dominique
Le Lien Urantien — Issue 48 — Autumn 2009	Le Lien Urantien — Número 48 — Otoño 2009
Le Lien Urantien — Issue 48 — Autum 2009 — Contents	Le Lien Urantien — Número 48 — Otoño de 2009
The Guest: The Extraterrestrial Usain Bolt	El invitado: el extraterrestre Usain Bolt
Human Philosophy and Mota (2)	Filosofía humana y mota (2)
The Osteoclast	El osteoclasto
Happiness	Felicidad
Serenity	Serenidad
Love and Respect for Life	Amor y respeto por la vida.
Rodan's Papers	Papeles Rodán
The Sailboat	El velero
When the Wind Blows at Night...	Cuando el viento sopla por la noche...
Brother Dominique's Little Corner	El pequeño rincón del hermano Dominique
Le Lien Urantien — Issue 49 — Winter 2009	Le Lien Urantien — Número 49 — Invierno 2009
Le Lien Urantien — Issue 49 — Winter 2009 — Contents	Le Lien Urantien — Número 49 — Invierno de 2009
The Living Water of UB	L'Eau Vive du LU
The President’s Note	La nota del presidente
Jean-François and the Seahorse	Jean-François y el caballito de mar
National Meeting at Notre Dame de Lumières	Encuentro nacional en Notre Dame de Lumières
Indefinite Pronouns	Pronombres indefinidos
Uncertainty and Security	Incertidumbre y seguridad
God, the Consumer of Universal Destiny	Dios, Consumidor del Destino Universal
The Apostles – The Lion	Los Apóstoles – El León
Our Emotions	Nuestras emociones
Gift of Love	Regalo de amor
Brother Dominique’s Little Corner	El pequeño rincón del hermano Dominique
2010	2010
Le Lien Urantien — Issue 50 — Spring 2010	Le Lien Urantien — Número 50 — Primavera 2010
Le Lien Urantien — Issue 50 — Spring 2010 — Contents	Le Lien Urantien — Número 50 - Primavera de 2010
Prayer	La oración
Malek Jân Ne’mati	Malek Jân Ne'mati
The “Our Father”	El “Padre Nuestro”
Maxi Quiz No. 1 Questions	Maxien cuestionario n°1 Las preguntas
Study of Prayers	Estudio de oraciones
The Presence of God	La presencia de Dios
Gift of Love (2)	Regalo de amor (2)
The Dual Nature	La doble naturaleza
Maxi Quiz No. 1 Answers	Maxien cuestionario n°1 Las respuestas
Brother Dom’s Little Corner	El pequeño rincón del hermano Dom
Le Lien Urantien — Issue 51 — Summer 2010	Le Lien Urantien — Número 51 — Verano 2010
Le Lien Urantien — Issue 51 — Summer 2010 — Contents	Le Lien Urantien — Número 51 - Verano de 2010
Gratitude	Reconocimiento
Bahaism	Bahaísmo
The “Our Father”	El «Padre Nuestro»
Maxi Quiz No. 2 Questions	Maxien cuestionario n°2 Las preguntas
The Philosophy That Saves	La filosofía que salva
Jesus’ Attitude Toward Women	La actitud de Jesús hacia las mujeres
Light, Light!	¡Luz, luz!
Meeting of 06.03.2010	Reunión del 03.06.2010
Trust	Confianza
Chales	Chales
Hermeticism and Eugenics	Hermetismo y eugenesia
Lyrical Pages	Páginas de letras
Being right or being happy	Tener razón o ser feliz.
Maxi Quiz n°2 The answers	Maxien cuestionario n°2 Las respuestas
Le Lien Urantien — Issue 52 — Autumn 2010	Le Lien Urantien — Número 52 — Otoño 2010
Le Lien Urantien — Issue 52 — Autum 2010 — Contents	El vínculo urantiano – Número 52 – Otoño de 2010
Humor	Humor
Elisabeth Sombart, the pianist of the Angels	Elisabeth Sombart, la pianista de Les Anges
Personality	Personalidad
Maxi Quiz n°3 The questions	Maxien cuestionario n°3 Las preguntas
Being Young	Ser joven
Reclosed	Cerrado nuevamente
My life in Paradise	Mi vida en el paraiso
God's CV	CV de Dios
Photos of 21.10.2010 C° Eliane	Fotos del 21.10.2010 C° Eliane
Reincarnation	Reencarnación
My garden	Mi jardin
Lyrical Pages	Páginas de letras
Success, instructions for use	Éxito, instrucciones de uso.
Maxi Quiz n°3 The answers	Maxien cuestionario n°3 Las respuestas
Brother Dom's Little Corner	El pequeño rincón del hermano Dom
Le Lien Urantien — Issue 53 — Winter 2010	Le Lien Urantien — Número 53 — Invierno 2010
Le Lien Urantien — Issue 53 — Winter 2010 — Contents	Le Lien Urantien — Número 53 - Invierno de 2010
United around a BOOK	Unidos en torno a un LIBRO
Brotherhood according to Theosophy	Fraternidad según la Teosofía
Are we ambassadors?	¿Somos embajadores?
The World of Mansions	El mundo de las casas
Maxi Quiz No. 4 The Questions	Maxien cuestionario n°4 Las preguntas
Prayers	Rezo
Poetry	Poesía
The 6th Adjutant Mental Spirit	El sexto espíritu mental ayudante
Comic Strip	Cómics humorísticos
Power Directors and Transcendentals	Directores de Poder y Trascendentales
Gliese 581	Gliese 581
Belgium 08/21/2010	Bélgica el 21/08/2010
RANTOWOC	RANTOWOC
Ganid	Ganid
Traits of Humor	Rasgos del humor
These Absurd Theories	Estas teorías absurdas
Maxi Quiz No. 4 The Answers	Maxien cuestionario n°4 Las respuestas
Brother Dom’s Little Corner	El pequeño rincón del hermano Dom
2011	2011
Le Lien Urantien — Issue 54 — Spring 2011	Le Lien Urantien — Número 54 — Primavera 2011
Le Lien Urantien — Issue 54 — Spring 2011 — Contents	Le Lien Urantien — Número 54 — Primavera de 2011
The Eternal	El Señor
Being Effective	Sea eficiente
The Deity	La deidad
Semi 2	Semi 2
Maxi Quiz #5 Questions	Quiz Maxien n°5 Las preguntas
Twilight	Crepúsculo
Forgive	Perdonar
Forgive	Perdonar
The Praise of Fatigue	El elogio del cansancio
On Understanding The Urantia Book	Sobre la comprensión del Libro de Urantia
The Resurrection of Ganid	La resurrección de Ganid
Universal Levels of Reality	Niveles universales de realidad
The Little Voice	La pequeña voz
Excerpts from The Life of the Masters	Extractos de Las vidas de los maestros
The Feminine Nature	Naturaleza femenina
Maxi Quiz #5 Answers	Maxien cuestionario n°5 Las respuestas
Brother Dom’s Little Corner	El pequeño rincón del hermano Dom
Le Lien Urantien — Issue 55 — Summer 2011	Le Lien Urantien — Número 55 — Verano 2011
Le Lien Urantien — Issue 55 — Summer 2011 — Contents	El vínculo uraniano — Número 55 — Verano de 2011
Paul and the Eternal Feminine	Pablo y el Eterno Femenino
The Heavenly Funerals	El funeral celestial
In the Footsteps of Paul	Tras los pasos de Pablo
Light 05-08 May 2011	Luz 05-08 de mayo de 2011
Maxi Quiz #6 Questions	Maxien cuestionario n°6 Las preguntas
The Immanence of God in Me	La inmanencia de Dios en mí.
The Blue Book	El libro azul
The WOMAN	La MUJER
The Year 1955, The Urantia Book….and the Poet	El año 1955, el Libro de Urantia….y el poeta
Race to the Other Earth	Carrera hacia la otra Tierra
Light 04-06 May 2011 (01)	Luz 4-06 de mayo de 2011 (01)
And God created woman...	Y Dios creó a la mujer...
Theosophical Review	Revisión teosófica
Maxi Quiz No. 6 The answers	Maxien cuestionario n°6 Las respuestas
Brother Dom’s Little Corner	El pequeño rincón del hermano Dom
Le Lien Urantien — Issue 56 — Autumn 2011	Le Lien Urantien — Número 56 — Otoño 2011
Le Lien Urantien — Issue 56 — Autum 2011 — Contents	El vínculo uraniano – Número 56 – Otoño de 2011
Travel Words	Palabras de viaje
Chicago, Paul and the Eternal Feminine	Chicago, Paul y lo eterno femenino
The Little Beatitudes	Las pequeñas bienaventuranzas
Chicago Symposium 2011	Simposio de Chicago 2011
Maxi Quiz No. 7 The questions	Maxien Quiz n°7 Las preguntas
You have value in my eyes	Eres valioso para mi
Ancient Prayers	Oraciones antiguas
Interview with God	Entrevista con Dios
A marvelous assembly	Una asamblea maravillosa
The hymn to love	El himno al amor.
The Universe and Nature, a mechanism of laws	El Universo y la Naturaleza, un mecanismo de leyes
The Woman	La mujer
Michael’s Birthday	El cumpleaños de miguel
Absolutely nothing and Me	Absolutamente nada y yo
Praise of the woman	Alabanza de la mujer
Jesus and women	Jesus y las mujeres
The return of the goddess	El regreso de la diosa
Chicago Symposium 2011 - Photos	Simposio de Chicago 2011 - Fotos
The Tupperware Saga	La saga de Tupperware
Maxi Quiz No. 7 The answers	Maxien Quiz n°7 Las respuestas
Caminante, no hay camino	Caminante, no hay camino
Le Lien Urantien — Issue 57 — Winter 2011	Le Lien Urantien — Número 57 — Invierno 2011
Le Lien Urantien — Issue 57 — Winter 2011 — Contents	Le Lien Urantien — Número 57 - Invierno de 2011
The President’s note	La nota del presidente
Paul and the Eternal Feminine (2)	Pablo y el Eterno Femenino (2)
Marie	Casado
Maxi Quiz n°8 The questions	Maxien Quiz n°8 Las preguntas
Exoplanets	Exoplanetas
The Seven Fundamental Realities (what is given)	Las Siete Realidades Fundamentales (lo que se da)
Genesis- Zizi - Computer	Génesis- Zizi - Computadora
The hymn to love (2)	El himno al amor (2)
The Journey of the Fathers	El viaje de los padres
Emergence - Pro Machiventa	Emergencia - Pro Maquiventa
Domaine de Châles	Domaine de Châles
The Etern-Feminine Wing	El ala eterna femenina
The Higgs boson	El bosón de Higgs
The Life of the Masters (extracts)	Las vidas de los maestros (extractos)
Quiz Maxien n°8 The answers	Maxien Quiz n°8 Las respuestas
Little Corner of Brother Dom’	El pequeño rincón del hermano Dom
2012	2012
Le Lien Urantien — Issue 58 — Spring 2012	Le Lien Urantien — Número 58 — Primavera 2012
Le Lien Urantien — Issue 58 — Spring 2012 — Contents	Le Lien Urantien — Número 58 — Primavera de 2012
The President's Note: Reunion	La nota del presidente: regreso a casa
Paul and the Eternal Feminine (3)	Pablo y el Eterno Femenino (3)
Philosophy Fundamental Concepts	Filosofía Conceptos fundamentales
Maxien Quiz No. 9 The Questions	Maxien Quiz n°9 Las preguntas
Artistic Scoop Free Interpretation "Adam-Eve"	Primicia artística Interpretación libre “Adán-Eva”
The Seven Fundamental Realities (what is given) Part II	Las Siete Realidades Fundamentales (lo dado) parte II
I have only you my "Father"	Sólo te tengo a ti mi “Padre”
Perpetual Calendar	Calendario perpetuo
The Sex of Angels	El sexo de los ángeles
Celebrating Life	Celebra la vida
The Impatient	Los impacientes
Tribute to François Dupont	Homenaje a François Dupont
My Attitude	Mi actitud
Everything Comes in Its Time	Todo llega a su tiempo.
The Prayer of Consent	La oración de consentimiento
The First Sentence of The Urantia Book	La primera frase del Libro de Urantia
Maxien Quiz No. 9 The Answers	Maxien Quiz n°9 Las respuestas
Brother Dom's Little Corner	El pequeño rincón del hermano Dom
Le Lien Urantien — Issue 59 — Summer 2012	Le Lien Urantien — Número 59 — Verano 2012
Le Lien Urantien — Issue 59 — Summer 2012 — Contents	Le Lien Urantien — Número 59 — Verano de 2012
The President's Note: Reunion	La nota del presidente: regreso a casa
La Neylière and Psychic Circles	La Neylière y los círculos psíquicos
Being Well	Estar bien
Self-Esteem	Autoestima
Maxien Quiz No. 10 The Questions	Maxien Quiz n°10 Preguntas
The Seven Fundamental Realities (what is given) Part III	Las Siete Realidades Fundamentales (lo que se da) parte III
Selected Excerpts	Piezas seleccionadas
La Neylière 2012	La Neylière 2012
Trust	Confianza
The Breath of God	El aliento de Dios
Self-esteem I	Autoestima yo
Empathy and Leadership	Empatía y Liderazgo
Quiz Maxien n°10 The answers	Maxien Quiz n°10 Las respuestas
Brother Dom's Little Corner	El pequeño rincón del hermano Dom
Le Lien Urantien — Issue 60 — Autumn 2012	Le Lien Urantien — Número 60 — Otoño 2012
Le Lien Urantien — Issue 60 — Autum 2012 — Contents	Le Lien Urantien — Número 60 – Otoño de 2012
The President’s note: Re	La nota del Presidente: Re
Artisans of Peace	Pacificadores
Suicide	Suicidio
Peace Initiatives	Iniciativas de paz
Quiz Maxien n°11 The questions	Maxien Quiz n°11 Las preguntas
The Seven Fundamental Realities part IV	Las Siete Realidades Fundamentales parte IV
Saint Philippe Néri	San Felipe Neri
An evening at the Neylière	Una velada en Neylière
The art of blessing	El arte de bendecir
Some passages from LU	Algunos pasajes del LU
In the footsteps of Jesus (fiction)	Tras las huellas de Jesús (ficción)
Self-esteem II	Autoestima II
Belgian meeting August 19, 2012	Reunión belga 19 de agosto de 2012
History	Historia
Quiz Maxien n°11 The answers	Maxien Quiz n°11 Las respuestas
Brother Dom's Little Corner	El pequeño rincón del hermano Dom
Le Lien Urantien — Issue 61 — Winter 2012	Le Lien Urantien — Número 61 — Invierno 2012
Le Lien Urantien — Issue 61 — Winter 2012 — Contents	El vínculo uraniano – Número 61 – Invierno de 2012
The President’s note: Rapprochement	La nota del Presidente: Reconciliación
Knowledge and Consciousness!	¡Conocimiento y Conciencia!
Free Will	Libre albedrío
When I Can Say...	Cuando puedo decir...
Quiz Maxien n°12 The Questions	Maxien Quiz n°12 Las preguntas
The Seven Fundamental Realities Part V	Las Siete Realidades Fundamentales parte V
Puns on Christianity	Juegos de palabras sobre el cristianismo
The Day When	El día en que
Conscience	Conciencia
Quiz Maxien n°11 The Answers 8 to 18 (updated)	Maxien Quiz n°11 Respuestas 8 a 18 (actualizado)
I Would Like to Dress Myself in God	Quisiera vestirme de dios
Self-Esteem III	Autoestima III
To Ask for Good Humor	Para pedir buen humor
Quiz Maxien n°12 The Answers	Maxien Quiz n°12 Las respuestas
Brother Dom’s Little Corner	El pequeño rincón del hermano Dom
2013	2013
Le Lien Urantien — Issue 62 — Spring 2013	Le Lien Urantien — Número 62 — Primavera 2013
Le Lien Urantien — Issue 62 — Spring 2013 — Contents	El vínculo urantiano – Número 62 – Primavera de 2013
The President's Note: Our Meeting Groups	Nota del Presidente: Nuestros grupos de encuentro
Love, Gratitude and Light	Amor, Gratitud y Luz
On Love I	Sobre el amor yo
The Sower	El sembrador
Maxian Quiz No. 13 The Questions	Maxien Quiz n°13 Las preguntas
The Seven Fundamental Realities VI	Las Siete Realidades Fundamentales VI
Jesus' Report Card	Boletín de calificaciones de Jesús
In the Light	En la luz
The Agondontarians	Los agondontaires
Love: The Heart of God	Amor: El Corazón de Dios
Pontius Pilate	Poncio Pilato
GRATITUDE	GRATITUD
Morning Prayer	Oración de la mañana
Our Christian Civilization is in Danger	Nuestra civilización cristiana está en peligro
Maxian Quiz No. 13 The Answers	Maxien Quiz n°13 Las respuestas
Brother Dom's Little Corner: The Part of the Dream	El pequeño rincón del hermano Dom: la parte del sueño
Le Lien Urantien — Issue 63 — Summer 2013	Le Lien Urantien — Número 63 — Verano 2013
Le Lien Urantien — Issue 63 — Summer 2013 — Contents	Le Lien Urantien — Número 63 — Verano de 2013
Abundance of Articles	Abundancia de artículos
On Love II	Sobre el amor II
God gives the Adjuster	Dios le dio al Ajustador
Maxian Quiz No. 14 The Questions	Maxien Quiz n°13 Las preguntas
The Seven Fundamental Realities VII	Las Siete Realidades Fundamentales VII
Pontius Pilate (Part 2)	Poncio Pilato (segunda parte)
Being Born of Spirit	Nacido del espíritu
The Reality of Personality	La realidad de la personalidad
Causes, Effects	Las causas, los efectos.
Deity - Divinity	Deidad - Divinidad
Rules for Being Human	Reglas para ser humano
Gay Marriage	Matrimonio homosexual
Maxian Quiz No. 14 The Answers	Maxien Quiz n°13 Las respuestas
Brother Dom's Little Corner Dom’ One Word!	El rincón del hermano pequeño Dom ¡Solo una palabra!
Le Lien Urantien — Issue 64 — Autumn 2013	Le Lien Urantien — Número 64 — Otoño 2013
Le Lien Urantien — Issue 64 — Autum 2013 — Contents	Le Lien Urantien — Número 64 – Otoño de 2013
The President’s Note Salon	Salón La nota del Presidente
Love, Gratitude and Light	Amor, Gratitud y Luz
On Love III	Sobre el amor III
Quiz Maxien n°15 The questions	Maxien Quiz n°15 Las preguntas
The Seven Fundamental Realities VII	Las Siete Realidades Fundamentales VII
The Reality of Personality II	La realidad de la personalidad II
Awakened to the fullness of life	Despertado a la plenitud de la vida.
The causes, the effects II	Causas, efectos II
The fairy	El hada
Quiz Maxien n°15 The answers	Maxien Quiz n°15 Las respuestas
Brother Dom’s Little Corner The Truth	El pequeño rincón del hermano Dom La verdad
Le Lien Urantien — Issue 65 — Winter 2013	Le Lien Urantien — Número 65 — Invierno 2013
Le Lien Urantien — Issue 65 — Winter 2013 — Contents	Le Lien Urantien — Número 65 - Invierno de 2013
The President’s Note Lumière	La nota del presidente Lumière
Love, again and again	Amor, una y otra vez
On Love IV	Sobre el amor IV
Quiz Maxien n°16 The questions	Maxien Quiz n°16 Preguntas
The Seven Fundamental Realities VIII	Las Siete Realidades Fundamentales VIII
The Power of Love	El poder del amor
Life	La vida
The Lotus Temple	El templo del loto
War Doctor	Médico de guerra
The causes, the effects III	Causas, efectos III
Death does not exist	La muerte no existe
Quiz Maxien n°16 The answers	Maxien Quiz n°16 Las respuestas
Brother Dom’s Little Corner Reading	El pequeño rincón de lectura del hermano Dom
2014	2014
Le Lien Urantien — Issue 66 — Spring 2014	Le Lien Urantien — Número 66 — Primavera 2014
Le Lien Urantien — Issue 66 — Spring 2014 — Contents	El vínculo urantiano – Número 66 – Primavera de 2014
The President's note General Appeal	Nota del Presidente Convocatoria General
Traffic jam	Atasco de tráfico
On Love V	Sobre el amor V
Quiz Maxien n°17 ​​The questions	Maxien Quiz n°17 Preguntas
The Seven Fundamental Realities IX	Las siete realidades fundamentales IX
Wise words (Khalil Gibran)	Sabias palabras (Khalil Gibran)
The LU and science	LU y la ciencia
The Project of Life	El proyecto de vida
The Olympic Values	Valores olímpicos
The causes, the effects IV	Causas, efectos IV
Quiz Maxien n°17 ​​The answers	Maxien Quiz n°17 Las respuestas
Brother Dom's Little Corner The Question!	El rincón del hermano pequeño Dom ¡La pregunta!
Le Lien Urantien — Issue 67 — Summer 2014	Le Lien Urantien — Número 67 — Verano 2014
Le Lien Urantien — Issue 67 — Summer 2014 — Contents	Le Lien Urantien — Número 67 — Verano de 2014
The President's note General Appeal	Nota del Presidente Convocatoria General
Editorial	Editorial
Another vision of the universe	Otra visión del universo.
Hindu philosophy Principles	Principios de la filosofía hindú
Quiz Maxien n°18 The questions	Maxien Quiz n°18 Preguntas
The Seven Fundamental Realities X	Las siete realidades fundamentales
The Deity	La deidad
Serenity	Serenidad
Buddhist philosophy Mindfulness	Filosofía Budista Mindfulness
The consecration of choice	La consagración de la elección
Small philosophical survival kit (Alexandra Ahouandjinou)	Pequeño kit de supervivencia filosófica (Alexandra Ahouandjinou)
In You	En ti
The causes, the effects V	Causas, efectos V
Quiz Maxien n°18 The answers	Maxien Quiz n°18 Las respuestas
Brother Dom's Little Corner The Question!	El rincón del hermano pequeño Dom ¡La pregunta!
Le Lien Urantien — Issue 68 — Autumn 2014	Le Lien Urantien — Número 68 — Otoño 2014
Le Lien Urantien — Issue 68 — Autum 2014 — Contents	Le Lien Urantien — Número 68 – Otoño de 2014
The President's Note Summary Jura meeting	El cargo del Presidente Resumen de la reunión del Jura
Editorial	Editorial
Resurrections of mortals after physical death	Resurrecciones de los mortales después de la muerte física.
Quiz Maxien n°19 The questions	Maxien Quiz n°19 Preguntas
The Seven Fundamental Realities XI	Las Siete Realidades Fundamentales XI
The New Jerusalem	La nueva Jerusalén
On the revised translation	De la traducción revisada
Prayer	Oración
On freedom and the mode of evolution of civilization	Sobre la libertad y el modo de evolución de la civilización
Mandela, Gandhi, M.L. King... And Jesus?	Mandela, Gandhi, M.L. King... ¿Y Jesús?
Quiz Maxien n°19 The answers	Maxien Quiz n°19 Las respuestas
Brother Dom's Little Corner Enjoyment!	¡El pequeño rincón del hermano Dom!
Le Lien Urantien — Issue 69 — Winter 2014	Le Lien Urantien — Número 69 — Invierno 2014
Le Lien Urantien — Issue 69 — Winter 2014 — Contents	Le Lien Urantien — Número 69 — Invierno de 2014
The President's Note All my best wishes	Nota del Presidente Todos mis mejores deseos
To God!	Despedida !
Quiz Maxien n°20 The questions	Maxien Quiz n°20 Preguntas
The Urantia Book in Study Groups	El libro de Urantia en grupos de estudio
Map of consciousness	Mapa de conciencia
The Hummingbird Movement	El movimiento del colibrí
The Shamengo team	El equipo de Shamengo.
Quiz Maxien n°20 The answers	Maxien Quiz n°19 Las respuestas
Brother Dom's Little Corner The latest one!	El rincón del hermano Dom ¡El más joven!
2015	2015
Le Lien Urantien — Issue 70 — Spring 2015	Le Lien Urantien — Número 70 — Primavera 2015
Le Lien Urantien — Issue 70 — Spring 2015 — Contents	Le Lien Urantien — Número 70 - Primavera de 2015
The President's Word	Una palabra del presidente
MAXIEN Quiz #21 and Last — Questions	MAXIEN Quiz n²21 y último — Preguntas
Thoughts on the Art of Merging	Reflexiones sobre el arte de fusionar
Quiz #21 — Answers	Prueba n.º 21: Respuestas
Le Lien Urantien — Issue 71 — Autumn 2015	Le Lien Urantien — Número 71 — Otoño 2015
Le Lien Urantien — Issue 71 — Autum 2015 — Contents	Le Lien Urantien — Número 71 – Otoño de 2015
Editorial	Editorial
Editorial Charter of the Link	Carta editorial del Enlace
Neylière Meeting	Reunión de Neylière
Extraordinary General Assembly	Asamblea General Extraordinaria
The Unconscious and the Superconscious	El inconsciente y el superconsciente
Interactive Study Group	Grupo de estudio interactivo
Publications on the Urantia Book	Publicaciones sobre el Libro de Urantia
Le Lien Urantien — Issue 72 — Winter 2015	Le Lien Urantien — Número 72 — Invierno 2015
Le Lien Urantien — Issue 72 — Winter 2015 — Contents	Le Lien Urantien — Número 72 - Invierno de 2015
Editorial	Editorial
Already 60 Years	Ya tengo 60 años
Bill Sadler's Study on Synthesis and Functional Coordination	El estudio de Bill Sadler sobre síntesis y coordinación funcional.
International Meeting of Quebec	Encuentro Internacional de Quebec
Consciousness — Self-Consciousness & God-Consciousness	Conciencia - Autoconciencia y Conciencia de Dios
Visit to Italy	Visita a Italia
Interactive Study Group: Second Series	Grupo de estudio interactivo: segunda serie
2016	2016
Le Lien Urantien — Issue 73 — March 2016	Le Lien Urantien — Número 73 — Marzo 2016Le Lien Urantien — Número 73 — Mars 2016
Le Lien Urantien — Issue 73 — March 2016 — Contents	Le Lien Urantien — Número 73 – Marzo de 2016
Editorial	Editorial
Following the Personality-Power Phenomenon	Siguiendo el fenómeno Personalidad-Poder
The Circuits of the Adjutant Mental Spirits	Los circuitos de los espíritus mentales ayudantes.
Pierrot	Pierrot
History of the French-speaking Movement in Europe	Historia del movimiento francófono en Europa
Role of Personality in Our Earthly Experience	Papel de la personalidad en nuestra experiencia terrenal.
Lumen	Lúmenes
European Conference in Budapest	Conferencia Europea de Budapest
Interactive Study Group: Third Series	Grupo de estudio interactivo: tercera serie
About the UBIS School	Acerca de la escuela UBIS
UBIS School Courses for the April Quarter	Cursos escolares de la UBIS para el semestre de abril
Le Lien Urantien — Issue 74 — June 2016	Le Lien Urantien — Número 74 — Junio 2016
Le Lien Urantien — Issue 74 — June 2016 — Contents	Le Lien Urantien — Número 74 – Junio de 2016
Editorial	Editorial
Effectively Revealing the Truth	Revelar eficazmente la verdad
Day and Period	Día y período
Another Vision of the Universe	Otra visión del universo
Friendship	Amistad
The Translation of The Urantia Book: State of Play	Traducción de El libro de Urantia: situación actual
The Diffusion of the Urantia Book in the World Projection 2015-2100	Proyección mundial de la difusión del Libro de Urantia 2015-2100
Interactive Study Group	Grupo de estudio interactivo
Italo-Franco-Swiss Congress	Congreso Italo-Franco-Suizo
Le Lien Urantien — Issue 75 — September 2016	Le Lien Urantien — Número 75 — Septiembre 2016
Le Lien Urantien — Issue 75 — September 2016 — Contents	Le Lien Urantien — Número 75 – Septiembre de 2016
Editorial	Editorial
Should We Be Afraid of Islam?	¿Deberías tener miedo del Islam?
Brief Reflections on Time	Breves reflexiones sobre el tiempo
ABFU Review and Resignation	Evaluación y renuncia a la ABFU
Spiritual Love	Amor espiritual
Goodbye Bernhard	Adiós Bernhard
Chales National Meeting	Encuentro Nacional de Chalès
2016 General Assembly Report	Informe de la Asamblea General de 2016
2016 Scientific Symposium in Chicago	Simposio Científico 2016 en Chicago
Unicellular Organism The Cambrian Explosion — Nanomachines	Organismo unicelular La explosión del Cámbrico — Nanomáquinas
Le Lien Urantien — Issue 76 — December 2016	Le Lien Urantien — Número 76 — Dieciembre 2016
Le Lien Urantien — Issue 76 — December 2016 — Contents	Le Lien Urantien — Número 76 – Diciembre de 2016
Editorial	Editorial
Budapest Conference Report	Informe de la Conferencia de Budapest
AFLLU 2015 Income Statement	Cuenta de resultados AFLLU 2015
Meeting in Italy Report	Informe de la reunión en Italia
Sub-Saharan Africa, Fertile Land for the Teachings of The Urantia Book	África subsahariana, tierras fértiles para las enseñanzas del Libro de Urantia
Meeting with Ade Awoyinka	Encuentro con Ade Awoyinka
Revealed Religion	Religión revelada
The Urantia Book in Cameroon	El libro de Urantia en Camerún
The Urantia Book in Burkina Faso	El libro de Urantia en Burkina Faso
Testimony from Ivory Coast	Testimonio de Costa de Marfil
How to Live with an Open Mind	Cómo vivir con una mente abierta
Implication of Free Will in the Cosmos	Implicaciones del libre albedrío en el cosmos
2017	2017
Le Lien Urantien — Issue 77 — March 2017	Le Lien Urantien — Número 77 — Marzo 2017
Le Lien Urantien — Issue 77 — March 2017 — Contents	Le Lien Urantien — Número 77 – Marzo de 2017
Editorial	Editorial
Jesus the Man	Jesús el hombre
Personality Research	Investigación de la personalidad
Parable “In the Way of Jesus”	Parábola “En el camino de Jesús”
From Primitive Prayer to Ethical Prayer: My Personal Experience	De la oración primitiva a la oración ética: mi experiencia personal
The Benefits of Group Prayer	Los beneficios de la oración en grupo
Le Lien Urantien — Issue 78 — June 2017	Le Lien Urantien — Número 78 — Junio 2017
Le Lien Urantien — Issue 78 — June 2017 — Contents	Le Lien Urantien — Número 78 – Junio de 2017
Editorial	Editorial
The Part Advances the Whole	La parte hace avanzar el todo
UBIS The Framework of Study — Pedagogy	UBIS El marco de estudio — Pedagogía
Planetary Overpopulation	Superpoblación planetaria
The Urantia Book: Corrections to the 1955 Text	El libro de Urantia: Correcciones al texto de 1955
10th International Conference of the UAI Association — Amsterdam, The Netherlands	Décima Conferencia Internacional de la Asociación UAI — Amsterdam Países Bajos
The Spiritual Brain	El cerebro espiritual
Le Lien Urantien — Issue 79 — September 2017	Le Lien Urantien — Número 79 — Septiembre 2017
Le Lien Urantien — Issue 79 — September 2017 — Contents	Le Lien Urantien — Número 79 – Septiembre de 2017
Editorial	Editorial
AFLLU Annual Meeting	Reunión anual de la AFLLU
Third Italian Readers’ Congress	Tercer Congreso de Lectores Italianos
Assembly of God	Asamblea de Dios
Belief and Faith	Creencia y fe
The UBIS Experience	La experiencia UBIS
Our Educational Imperatives	Nuestros imperativos educativos
Report of the 2017 National Meeting	Informe del Encuentro Nacional 2017
Le Lien Urantien — Issue 80 — December 2017	Le Lien Urantien — Número 80 — Dieciembre 2017
Le Lien Urantien — Issue 80 — December 2017 — Contents	Le Lien Urantien — Número 80 – Diciembre de 2017
Editorial	Editorial
The Universe Is There, Chance Has Nothing to Do With It	El universo está ahí, el azar no tiene nada que ver con él.
The Term “Tension” Can It Enlighten Us on the Trinity	¿Puede el término “tensión” iluminarnos sobre la Trinidad?
Questioning God the Sevenfold and Other Definitions	Preguntas sobre Dios Séptuple y otras definiciones
Meeting in Italy	Reunión en Italia
European Meeting in Spain	Encuentro europeo en España
Toulon Book Fair	Feria del Libro de Tolón
2018	2018
Le Lien Urantien — Issue 81 — March 2018	Le Lien Urantien — Número 81 — Marzo 2018
Le Lien Urantien — Issue 81 — March 2018 — Contents	Le Lien Urantien — Número 81 – Marzo de 2018
Editorial	Editorial
Jean Royer has left us	Jean Royer nos ha dejado
Tribute to Jean Royer	Homenaje a Jean Royer
Dear Jean	Querido Jean
Returning to God	Volver a dios
My Mind is Pitiful	Mi mente es lamentable
To you, Universal Father, To you, Supreme Mother	A ti Padre Universal, A ti Madre Suprema
Original Concepts	Conceptos originales
Death	Muerte
Le Lien Urantien — Issue 82 — June 2018	Le Lien Urantien — Número 82 — Junio 2018
Le Lien Urantien — Issue 82 — June 2018 — Contents	Le Lien Urantien — Número 82 – Junio de 2018
Editorial	Editorial
The Truth personally discovered	Verdad personal descubierta
In Search of the Beyond	En busca del más allá
The Child Jesus and the Doctors of the Law	El niño Jesús y los doctores de la Ley
Being Sensitive to the Personality Circuit	Sea sensible al circuito de la Personalidad
The Dropper, the Spoon and the Shovel	El cuentagotas, la cuchara y la pala
The International Meeting in Amsterdam	El encuentro internacional en Amsterdam
IV Congress in Italy	IV Congreso en Italia
Le Lien Urantien — Issue 83 — September 2018	Le Lien Urantien — Número 83 — Septiembre 2018
Le Lien Urantien — Issue 83 — September 2018 — Contents	Le Lien Urantien — Número 83 – Septiembre de 2018
Editorial	Editorial
Annual Meeting of the AFLLU	Reunión anual de la AFLLU
Studying The Urantia Book in Groups	Estudio grupal del libro de Urantia
Prayer in the Form of a Poem	Oración en forma de poema
Electrons-Neutrons-Protons	Electrones-Neutrones-Protones
The Birth of the Spirit	El nacimiento del espíritu
News from Cameroon	Noticias de Camerún
Le Lien Urantien — Issue 84 — December 2018	Le Lien Urantien — Número 84 — Dieciembre 2018
Le Lien Urantien — Issue 84 — December 2018 — Contents	Le Lien Urantien — Número 84 — Diciembre de 2018
Editorial	Editorial
She Trembles on the Edge	Ella se estremece al borde
Visit to England	Visita a inglaterra
Visit to Italy	Visita a Italia
All These Trips in Europe	Todos estos viajes a Europa
Our Adventure	Nuestra Aventura
Studying The Urantia Book. What For?	Estudien el Libro de Urantia. ¿Para qué hacer?
The Parables	Las parábolas
2019	2019
Le Lien Urantien — Issue 85 — March 2019	Le Lien Urantien — Número 85 — Marzo 2019
Le Lien Urantien — Issue 85 — March 2019 — Contents	Le Lien Urantien — Número 85 – Marzo de 2019
Editorial	Editorial
Lecture in Tallinn	Conferencia en Tallin
One Ridge Can Hide Another	Una cresta puede ocultar otra
The Parables	Las parábolas
How Long Until Heaven	¿Cuánto falta para el cielo?
Our Adventure	Nuestra Aventura
AFLLU Annual Meeting At Notre Dame des Lumières	Reunión Anual de la AFLLU en Notre Dame des Lumières
Le Lien Urantien — Issue 86 — June 2019	Le Lien Urantien — Número 86 — Junio 2019
Le Lien Urantien — Issue 86 — June 2019 — Contents	Le Lien Urantien — Número 86 – Junio de 2019
Editorial	Editorial
The Symbolism of Numbers	El simbolismo de los números.
Energy and Food	Energía y Alimentos
Time, Energy and Matter	Tiempo, energía y materia
A Love Story	Una historia de amor
The World Cultural Symposium	El Simposio Cultural Mundial
Our Adventure	Nuestra Aventura
Le Lien Urantien — Issue 87 — September 2019	Le Lien Urantien — Número 87 — Septiembre 2019
Le Lien Urantien — Issue 87 — September 2019 — Contents	Le Lien Urantien — Número 87 — Septiembre de 2019
Editorial	Editorial
Havona and Heaven	Havona y el paraíso
Growth in the Kingdom of Heaven	Crecimiento en el Reino de los Cielos
Study on Guardian Angels	Estudio sobre ángeles guardianes
Report of the AFLLU Ordinary General Meeting	Acta de la Asamblea General Ordinaria de la AFLLU
Meeting in Italy Vth Congress	Reunión En Italia V Congreso
Communication by Johana August 21, 2019	Comunicación de Johana 21 de agosto de 2019
The Urantia Book Is a Bulky Book	El libro de Urantia es un libro voluminoso
Le Lien Urantien — Issue 88 — December 2019	Le Lien Urantien — Número 88 — Dieciembre 2019
Le Lien Urantien — Issue 88 — December 2019 — Contents	Le Lien Urantien — Número 88 — Diciembre de 2019
Editorial	Editorial
On the First Moments of Survival	Sobre los primeros momentos de supervivencia
When Are We Granted Personality?	¿Cuándo se nos concede la personalidad?
When Are We Granted Personality?	¿Cuándo se nos concede la personalidad?
Some information about Urantia Foundation	Alguna información sobre la Fundación Urantia
Search, Discover, Understand	Buscar, descubrir, comprender
2020	2020
Le Lien Urantien — Issue 89 — March 2020	Le Lien Urantien — Número 89 — Marzo 2020
Le Lien Urantien — Issue 89 — March 2020 — Contents	Le Lien Urantien — Número 89 – Marzo de 2020
Editorial	Editorial
Christianity As An Opportunity	El cristianismo como oportunidad
Water: Truth, Beauty, And Goodness	Agua: Verdad, Belleza y Bondad
A Great Confusion About Race	Gran confusión sobre la raza
National Meeting At Notre Dame Des Lumières	Encuentro Nacional en Notre Dame Des Lumières
Le Lien Urantien — Issue 90 — June 2020	Le Lien Urantien — Número 90 — Junio 2020
Le Lien Urantien — Issue 90 — June 2020 — Contents	Le Lien Urantien — Número 90 – Junio de 2020
Editorial	Editorial
Human Personality	Personalidad humana
Contact With The Thought Adjuster	Contacto con el Ajustador del Pensamiento
For Jesus	Para Jesús
In This Matter	En este asunto
Essays On Defining Space	Ensayos de definición de espacio
Reflection On Thought	Reflexión sobre el pensamiento
Who Am I?	¿Quién soy yo?
Le Lien Urantien — Issue 91 — September 2020	Le Lien Urantien — Número 91 — Septiembre 2020
Le Lien Urantien — Issue 91 — September 2020 — Contents	Le Lien Urantien — Número 91 — Septiembre de 2020
Editorial	Editorial
“The Intergalactic Wanderer”	“El viajero intergaláctico”
The Prophets	Los profetas
How Big Is Paradise?	¿Cuál es el tamaño del paraíso?
Earthly Escape	Escape terrestre
The Soul Within	El alma dentro de sí misma.
Is There An Archetype, An Ideal Model For The Relationship Between Man And Woman?	¿Existe un arquetipo, un modelo ideal de relación hombre-mujer?
Le Lien Urantien — Issue 92 — December 2020	Le Lien Urantien — Número 92 — Dieciembre 2020
Le Lien Urantien — Issue 92 — December 2020 — Contents	Le Lien Urantien — Número 92 — Diciembre de 2020
Editorial	Editorial
Study Revelation For What?	¿Estudiar el Apocalipsis para saber qué hacer?
Science And Revelations	Ciencia y revelaciones
A Universe Without The Big Bang	Un universo sin big bang
The Urantia Book In Esperanto	El libro de Urantia en esperanto
Personality	Personalidad
Can We Still Hunt The Dinosaur In Satania?	¿Podemos todavía cazar dinosaurios en Satania?
2021	2021
Le Lien Urantien — Issue 93 — March 2021	Le Lien Urantien — Número 93 — Marzo 2021
Le Lien Urantien — Issue 93 — March 2021 — Contents	Le Lien Urantien — Número 93 – Marzo de 2021
Editorial	Editorial
Prayer Was Not One	La oración no era una
The Urantia Book And The Grand Conspiracy Theory?	¿El libro de Urantia y la teoría de la gran conspiración?
Foundation News	Noticias de la Fundación
The UBIS School Why Do It?	¿Para qué sirve la escuela UBIS?
A Fantastic Journey	Un viaje fantástico
From Energy To Matter	De la energía a la materia
4000 Years Of Machiventa Melchizedek	4000 años de Maquiventa Melquisedec
Jesus' Journeys Before His Public Ministry	Los viajes de Jesús antes de su ministerio público
Jesus' Life Timeline	Cronología de la vida de Jesús
Jesus' Appearances	Las apariciones de Jesús
The Train	El tren
Le Lien Urantien — Issue 94 — June 2021	Le Lien Urantien — Número 94 — Junio 2021
Le Lien Urantien — Issue 94 — June 2021 — Contents	Le Lien Urantien — Número 94 – Junio de 2021
Editorial	Editorial
Introducing The Urantia Book	Presentación del Libro de Urantia
Perfume Of A Woman	Perfumes de mujer
Experiencing Perfection	La experiencia de la perfección
For Geneticists	Para genetistas
God, Time, And The Universe	Dios, el tiempo y el universo
Le Lien Urantien — Issue 95 — September 2021	Le Lien Urantien — Número 95 — Septiembre 2021
Le Lien Urantien — Issue 95 — September 2021 — Contents	Le Lien Urantien — Número 95 — Septiembre de 2021
Editorial	Editorial
The Urantia Cosmogony	La cosmogonía de Urantia
Science Or Revelation	Ciencia o revelación
Life In Spirit	Vida en espíritu
What The Urantia Book Means To Me	Lo que el libro de Urantia significa para mí
God, Time, The Universe	Dios, el tiempo, el universo.
Reprinting The Urantia Book	Reimpresión del libro de Urantia
Le Lien Urantien — Issue 96 — December 2021	Le Lien Urantien — Número 96 — Dieciembre 2021
Le Lien Urantien — Issue 96 — December 2021 — Contents	Le Lien Urantien — Número 96 — Diciembre de 2021
Editorial	Editorial
MAX Is In Transit To Maisonia No. 1 From Jerusem	MAX está en tránsito hacia Maisonia Nº1 De Jérusem
Progress Through Education	Progreso a través de la educación
Promise Me	Prométeme
A Global Vision	Una visión global
Philosophical Pause	Ruptura filosófica
Foundation News	Noticias de la Fundación
Vive La Différence	¡Viva la diferencia!
2022	2022
Le Lien Urantien — Issue 97 — March 2022	Le Lien Urantien — Número 97 — Marzo 2022
Le Lien Urantien — Issue 97 — March 2022 — Contents	Le Lien Urantien — Número 97 – Marzo de 2022
Editorial	Editorial
Time and Levels of Consciousness	Tiempo y niveles de conciencia
How to Do the Will of the Father	Cómo hacer la voluntad del padre
The Seven Master Spirits	Los siete espíritus maestros
The History of Life	La historia de la vida
Cell Division (Wikipedia)	La división celular (Wikipedia)
EON (Wikipedia)	EON (Wikipedia)
The Earth	Tierra
Consciousness and Superconsciousness	Conciencia y Superconciencia
Le Lien Urantien — Issue 98 — June 2022	Le Lien Urantien — Número 98 — Junio 2022
Le Lien Urantien — Issue 98 — June 2022 — Contents	Le Lien Urantien — Número 98 – Junio de 2022
Editorial	Editorial
A Spiritual Quest: God in Question	Una búsqueda espiritual: Dios en cuestión
From Divine Incompleteness to Human Adventure	De la incompletitud divina a la aventura humana
The Hazards of a Decimal Planet	Los peligros de un planeta decimal
The Foundation Communicates: The Future of Urantia: Elements for Reflection	La Fundación Comunica: El futuro de Urantia: Elementos para la reflexión
The Earth	Tierra
Le Lien Urantien — Issue 99 — September 2022	Le Lien Urantien — Número 99 — Septiembre 2022
Le Lien Urantien — Issue 99 — September 2022 — Contents	Le Lien Urantien — Número 99 – Septiembre de 2022
Editorial	Editorial
The Wisdom of Creating Unequal Races	La sabiduría de crear razas desiguales
The Wisdom of Creating Unequal Races	La sabiduría de crear razas desiguales
Why I Believe in God	Por qué creo en Dios
The Human Personality	Personalidad humana
News from the Foundation	Noticias de la Fundación
3rd European Urantia Congress in Spain	3er Congreso Europeo Urantia en España
A Birthday	Un cumpleaños
Le Lien Urantien — Issue 100 — December 2022	Le Lien Urantien — Número 100 — Dieciembre 2022
Le Lien Urantien — Issue 100 — December 2022 — Contents	Le Lien Urantien — Número 100 – Diciembre de 2022
Editorial	Editorial
AUGUST 21, 2022	21 DE AGOSTO DE 2022
Dare to God	Atrévete Dios
News from the French-speaking Groups	Noticias de grupos francófonos
Lumieres 2022	Luces 2022
Relationships Between Material, Mental and Spirit	Relaciones entre material, mente y espíritu
Urantia Conference In Uganda 2022	Conferencia de Urantia en Uganda 2022
General Assembly Report	Acta de la Asamblea General
2023	2023
Le Lien Urantien — Issue 101 — March 2023	Le Lien Urantien — Número 101 — Marzo 2023
Le Lien Urantien — Issue 101 — March 2023 — Contents	Le Lien Urantien — Número 101 – Marzo de 2023
Editorial	Editorial
Relationships between material, mental and spirit	Relaciones entre materia, mente y espíritu
At the Tomb	En la tumba
Revelation of the Middle Ages	Revelación de la Edad Media
Our UBIS Experience	Nuestra experiencia UBIS
Fantasy on a Major Theme	Fantasía sobre un tema importante
Activities Dakar Group	Actividades del grupo Dakar
Ministry in the Philippines	Ministerio en Filipinas
UBIS School	Escuela UBIS
Urantia Foundation News	Noticias de la Fundación Urantia
Le Lien Urantien — Issue 102 — June 2023	Le Lien Urantien — Número 102 — Junio 2023
Le Lien Urantien — Issue 102 — June 2023 — Contents	Le Lien Urantien — Número 102 – Junio de 2023
Editorial	Editorial
AFLLU Meeting	Reunión de la AFLLU
AFLLU Report	Informe AFLLU
Testimonials	Testimonios
Adjuster, Absoluteness and Fusion	Ajustador, Absolución y Fusión
The House	La casa
Readers' Mail	Correo de los lectores
Le Lien Urantien — Issue 103 — September 2023	Le Lien Urantien — Número 103 — Septiembre 2023
Le Lien Urantien — Issue 103 — September 2023 — Contents	Le Lien Urantien — Número 103 – Septiembre de 2023
Editorial	Editorial
Life	La vida
Fantasy on a Major Theme	Fantasía sobre un tema importante
Feedback	Comentario
Some Comments on the Difficulties of Disseminating the 5th Revelation	Algunos comentarios sobre las dificultades de difusión de la quinta revelación
The Cat's Poem	El poema del gato
On the Necessary Fertilization of Our Thought	Sobre la necesaria fertilización de nuestro pensamiento
Dispensational Resurrections — Planetary Ages	Resurrecciones Dispensacionales — Eras Planetarias
Le Lien Urantien — Issue 104 — December 2023	Le Lien Urantien — Número 104 — Dieciembre 2023
Le Lien Urantien — Issue 104 — December 2023 — Contents	Le Lien Urantien — Número 104 - Diciembre de 1996
Editorial	Editorial
Will We Be Eternally Subject to Material Gravity?	¿Estaremos eternamente sujetos a la gravedad material?
At the Theater of Time	En el teatro del tiempo
The Flask	La botella
Will, Personality, Moral Choice	Voluntad, personalidad, elección moral.
History of the Journal Reflectivity	Reflectividad del historial de registros
Cosmic Consciousness and Spiritual Perception	Conciencia Cósmica y Percepción Espiritual
Readers' Mail	Correo de los lectores
2024	2024
Le Lien Urantien — Issue 105 — March 2024	Le Lien Urantien — Número 105 — Marzo 2024
Le Lien Urantien — Issue 105 — March 2024 — Contents	Le Lien Urantien — Número 105 – Marzo de 2024
Editorial	Editorial
Abortion	Aborto provocado
Urantia Foundation News	Noticias de la Fundación Urantia
Philosophical and Historical Approach to Quantum Mechanics	Aproximación filosófica e histórica a la mecánica cuántica.
The Chinese Translation of The Urantia Book	La traducción china del Libro de Urantia
Differences Between Simplified and Traditional Chinese Characters	Diferencias entre caracteres chinos simplificados y tradicionales
Le Lien Urantien — Issue 106 — June 2024	Le Lien Urantien — Número 106 — Junio 2024
Le Lien Urantien — Issue 106 — June 2024 — Contents	Le Lien Urantien — Número 106 – Junio de 2024
Editorial	Editorial
Part Two: The Revelation	Segunda parte: La revelación
Tale of the Three Thinkers	Cuento de los tres pensadores
Will We Survive?	¿Sobreviviremos?
Repersonalization	Repersonalización
Discovering Paradise and Space-Time	Descubriendo el paraíso y el espacio-tiempo
AFLLU Conference 2025 In Paris (France) AFLLU	Conferencia AFLLU 2025 en París (Francia) AFLLU
Le Lien Urantien — Issue 107 — September 2024	Le Lien Urantien — Número 107 — Septiembre 2024
Le Lien Urantien — Issue 107 — September 2024 — Contents	Le Lien Urantien — Número 107 – Septiembre de 2024
Editorial	Editorial
The Woman	La mujer
What is Behind the "I AM"?	Detrás del “YO SOY” ¿qué hay?
Lost Tradition	Tradición perdida
I AM and the Principle of Causality	YO SOY y el Principio de Causalidad
The Little Seed	La pequeña semilla
European Meeting 2025	Encuentro Europeo 2025
AFLLU Meeting — Neylieres 2024	Reunión de la AFLLU — Neylieres 2024
Report of the National Meeting of the A.F.L.L.U	Informe de la reunión nacional de la AFLLU