Index of Spanish Association “Luz y Vida” articles	Índice de la revista “Luz y Vida” de la Asociación de España
2005	2005
Luz y Vida — No. 1 — May 2005	Luz y Vida — Núm. 1 — Mayo 2005
Luz y Vida — No. 1 — Presentation	Luz y Vida — Núm. 1 — Presentación
The seven superuniverses	Los siete superuniversos
The Trinitized Sons of God	Los Hijos de Dios trinidizados
The mansion worlds	Los mundos de estancia
The spheres of light and life	Las esferas de luz y vida
The evolution of prayer	La evolución de la oración
The Supreme Being	El Ser Supremo
After Pentecost	Después de Pentecostés
Faith of jesus	La fe de Jesús
Luz y Vida — No. 2 — September 2005	Luz y Vida — Núm. 2 — Septiembre 2005
Luz y Vida — No. 2 — Presentation	Luz y Vida — Núm. 2 — Presentación
A personal overview, part one	Un panorama personal, primera parte
The center of attention	El centro de atención
The Urantia Book in Africa: account of a trip to Dakar	El Libro de Urantia en África: relato de un viaje a Dakar
Meeting of May 14, 1999 in Dakar (Senegal), first part	Encuentro del 14 de mayo de 1999 en Dakar (Senegal), primera parte
Luz y Vida — No. 3 — December 2005	Luz y Vida — Núm. 3 — Diciembre 2005
Luz y Vida — No. 3 — Presentation	Luz y Vida — Núm. 3 — Presentación
A personal overview, part two	Un panorama personal, segunda parte
The substitutes	Los sustitutos
Meeting of May 14, 1999 in Dakar (Senegal), second part	Encuentro del 14 de mayo de 1999 en Dakar (Senegal), segunda parte
We are children of the Supreme	Somos hijos del Supremo
2006	2006
Luz y Vida — No. 4 — February 2006	Luz y Vida — Núm. 4 — Febrero 2006
Luz y Vida — No. 4 — Presentation	Luz y Vida — Núm. 4 — Presentación
A Personal View, Part Three	Un panorama personal, tercera parte
Friends and Residents on Urantia	Amigos y residentes en Urantia
What are the seven mansion worlds for?	¿Para qué sirven los siete mundos de las mansiones?
The data	El dato
An infinite moment (poem)	Un instante infinito (poema)
Discernment and free will	Discernimiento y libre albedrío
VI Meeting of Urantia Book Readers in Spain	VI Encuentro de Lectores del Libro de Urantia en España
Luz y Vida — No. 5 — May 2006	Luz y Vida — Núm. 5 — Mayo 2006
Luz y Vida — No. 5 — Presentation	Luz y Vida — Núm. 5 — Presentación
How to publicize The Urantia Book	Cómo dar a conocer El Libro de Urantia
Study groups	Los grupos de estudio
How to live the teachings of The Urantia Book	Cómo vivir las enseñanzas del Libro de Urantia
Chronicle of the VI Meeting	Crónica del VI Encuentro
Luz y Vida — No. 6 — September 2006	Luz y Vida — Núm. 6 — Septiembre 2006
Luz y Vida — No. 6 — Presentation	Luz y Vida — Núm. 6 — Presentación
Back with the Dissemination	A Vueltas con la Diseminación
Orvonton and the Milky Way	Orvonton y La Vía Láctea
God The Absolute	Dios El Absoluto
Beyond Mathematics	Más Allá de las Matemáticas
Luz y Vida — No. 7 — December 2006	Luz y Vida — Núm. 7 — Diciembre 2006
Luz y Vida — No. 7 — Presentation	Luz y Vida — Núm. 7 — Presentación
Orvonton and the Milky Way (second part)	Orvonton y la Vía Láctea (segunda parte)
A way to get closer to the consciousness of God	Un camino para acercarse a la conciencia de Dios
The adventure of living	La aventura de vivir
Where metaphysics fails completely	Allí donde la metafísica fracasa completamente
Praise God	Loa a Dios
2007	2007
Luz y Vida — No. 8 — February 2007	Luz y Vida — Núm. 8 — Febrero 2007
Luz y Vida — No. 8 — Presentation	Luz y Vida — Núm. 8 — Presentación
Orvonton and the Milky Way (part three)	Orvonton y la Vía Láctea (tercera parte)
Path of Paradise	Camino del Paraíso
What mansion world are we going to?	¿A qué mundo mansión vamos?
Luz y Vida — No. 9 — May 2007	Luz y Vida — Núm. 9 — Mayo 2007
Luz y Vida — No. 9 — Presentation	Luz y Vida — Núm. 9 — Presentación
Urantia present, spectacular and enviable?	Presente de Urantia, ¿espectacular y envidiable?
Future of Urantia according to the UB	Futuro de Urantia según el LU
Eden project	Proyecto Edén
Luz y Vida — No. 10 — September 2007	Luz y Vida — Núm. 10 — Septiembre 2007
Luz y Vida — No. 10 — Presentation	Luz y Vida — Núm. 10 — Presentación
Jerusem circles	Los círculos de Jerusem
Live a new life	Vivir una nueva vida
The star of Bethlehem	La estrella de Belén
Communications between worlds	Comunicaciones entre mundos
Luz y Vida — No. 11 — December 2007	Luz y Vida — Núm. 11 — Diciembre 2007
Luz y Vida — No. 11 — Presentation	Luz y Vida — Núm. 11 — Presentación
Holy places? (first part)	¿Lugares Santos? (primera parte)
How many survive?	¿Cuántos sobreviven?
News about the UAI International Conference and Spain Association	Noticias sobre la Conferencia Internacional 2009 y la Asociación Urantia de España
2008	2008
Luz y Vida — No. 12 — February 2008	Luz y Vida — Núm. 12 — Febrero 2008
Luz y Vida — No. 12 — Presentation	Luz y Vida — Núm. 12 — Presentación
Holy places? (second part)	¿Lugares Santos? (segunda parte)
What is expected of us?	¿Qué se espera de nosotros?
More about how many survive (part one)	Más sobre cuántos sobreviven (primera parte)
News about the UAI International Conference	Noticias sobre la Conferencia Internacional UAI
Luz y Vida — No. 13 — May 2008	Luz y Vida — Núm. 13 — Mayo 2008
Luz y Vida — No. 13 — Presentation	Luz y Vida — Núm. 13 — Presentación
More about how many survive (second part)	Más sobre cuántos sobreviven (segunda parte)
Poem to the Adjuster	Poema al Ajustador
VIII Meeting of Readers of the Urantia Book in Spain	VIII Encuentro de Lectores del Libro de Urantia en España
News about the 2009 UAI International Conference	Noticias sobre la Conferencia Internacional AUI 2009
Luz y Vida — No. 14 — September 2008	Luz y Vida — Núm. 14 — Septiembre 2008
Luz y Vida — No. 14 — Presentation	Luz y Vida — Núm. 14 — Presentación
Causes and effects	Causas y efectos
Prayer for every night	Oración para todas las noches
Do all mortals survive?	¿Sobreviven todos los mortales?
More about how many survive (last part)	Más sobre cuántos sobreviven (última parte)
Transcendence	Trascendencia
News from Urantia Association of Spain	Noticias de la Asociación Urantia de España
Luz y Vida — No. 15 — December 2008	Luz y Vida — Núm. 15 — Diciembre 2008
Luz y Vida — No. 15 — Presentation	Luz y Vida — Núm. 15 — Presentación
Jesus and the Samaritan woman	Jesús y la samaritana
Adjuster and experience	El Ajustador y la experiencia
The Urantia Book and its dissemination	El Libro de Urantia y su difusión
News from Urantia Association of Spain	Noticias de la Asociación Urantia de España
2009	2009
Luz y Vida — No. 16 — February 2009	Luz y Vida — Núm. 16 — Febrero 2009
Luz y Vida — No. 16 — Presentation	Luz y Vida — Núm. 16 — Presentación
The mind according to revelation (second part)	La mente según la revelación (segunda parte)
There is always a beginning	Siempre hay un comienzo
The Alchemy of Creation	La Alquimia de la Creación
News from Urantia Association of Spain	Noticias de la Asociación Urantia de España
Luz y Vida — No. 17 — May 2009	Luz y Vida — Núm. 17 — Mayo 2009
Luz y Vida — No. 17 — Presentation	Luz y Vida — Núm. 17 — Presentación
Genesis of the International Conference	Génesis de la Conferencia Internacional
Highlights of the International Conference	Lo más destacado de la Conferencia Internacional
Luz y Vida — No. 18 — September 2009	Luz y Vida — Núm. 18 — Septiembre 2009
Luz y Vida — No. 18 — Presentation	Luz y Vida — Núm. 18 — Presentación
The mind according to revelation (last part)	La mente según la revelación (última parte)
The unmanifested	Lo no manifestado
How many mortals survive	Cuántos mortales sobreviven
The four candles	Las cuatro velas
News from Urantia Association of Spain	Noticias de la Asociación Urantia de España
Luz y Vida — No. 19 — December 2009	Luz y Vida — Núm. 19 — Diciembre 2009
Luz y Vida — No. 19 — Presentation	Luz y Vida — Núm. 19 — Presentación
Ideas about the size of Satania and other administrative units of Orvonton	Ideas sobre el tamaño de Satania y otras unidades administrativas de Orvonton
About Forgiveness	Sobre el perdón
Was God wrong?	¿Se equivocó Dios?
Road to Paradise (poem)	Camino del Paraíso (poema)
The absonite (part one)	Lo absonito (primera parte)
News from Urantia Association of Spain	Noticias de la Asociación Urantia de España
2010	2010
Luz y Vida — No. 20 — March 2010	Luz y Vida — Núm. 20 — Marzo 2010
Luz y Vida — No. 20 — Presentation	Luz y Vida — Núm. 20 — Presentación
The absonite (second part)	Lo absonito (segunda parte)
Trinitizing	Trinizando
UFOs, a positive approach to the matter	OVNIS, un enfoque positivo del asunto
News from Urantia Association of Spain	Noticias de la Asociación Urantia de España
Luz y Vida — No. 21 — June 2010	Luz y Vida — Núm. 21 — Junio 2010
Luz y Vida — No. 21 — Presentation	Luz y Vida — Núm. 21 — Presentación
IX Meeting of Readers of The Urantia Book in Spain	IX Encuentro de Lectores de El Libro De Urantia En España
News from Urantia Association of Spain	Noticias de la Asociación Urantia de España
Luz y Vida — No. 22 — August 2010	Luz y Vida — Núm. 22 — Agosto 2010
Luz y Vida — No. 22 — Presentation	Luz y Vida — Núm. 22 — Presentación
Paradise and the topology of space: a theory of ultimate matter	El Paraíso y la topología del espacio: una teoría de la materia última
Agora	Ágora
The Urantia Book, a book for hope	El Libro de Urantia, un libro para la esperanza
The true sun (poem)	El sol verdadero (poema)
Personal reflection (true, false, I don't know)	Reflexión personal (verdadero, falso, no lo sé)
The Urantia movement in Spain with the new European edition	El movimiento Urantia en España con la nueva edición europea
News from Urantia Association of Spain	Noticias de la Asociación Urantia de España
Luz y Vida — No. 23 — December 2010	Luz y Vida — Núm. 23 — Diciembre 2010
Luz y Vida — No. 23 — Presentation	Luz y Vida — Núm. 23 — Presentación
Hawking rules out the existence of God (part one)	Hawking descarta la existencia de Dios (primera parte)
Morning Star (poem)	Lucero de la mañana (poema)
Selfless service	Servicio desinteresado
The god who learns	El dios que aprende
EcoAltea: our first fair	EcoAltea: nuestra primera feria
2011	2011
Luz y Vida — No. 24 — March 2011	Luz y Vida — Núm. 24 — Marzo 2011
Luz y Vida — No. 24 — Presentation	Luz y Vida — Núm. 24 — Presentación
Hawking rules out the existence of God (last part)	Hawking descarta la existencia de Dios (última parte)
Meanwhile (poem)	Mientras tanto (poema)
The unification of the personality (first part)	La unificación de la personalidad (primera parte)
They left us alone	Nos dejaron solos
News from Urantia Association of Spain	Noticias de la Asociación Urantia de España
Luz y Vida — No. 25 — June 2011	Luz y Vida — Núm. 25 — Junio 2011
Luz y Vida — No. 25 — Presentation	Luz y Vida — Núm. 25 — Presentación
X Meeting of readers of The Urantia Book	X Encuentro de lectores de El Libro de Urantia
Melodies for the soul	Melodías para el alma
The questions	Las preguntas
the discussions	Los debates
Presentation of The Urantia Book at the Seville Book Fair	Presentación de El Libro de Urantia en la Feria del Libro de Sevilla
Luz y Vida — No. 26 — September 2011	Luz y Vida — Núm. 26 — Septiembre 2011
Luz y Vida — No. 26 — Presentation	Luz y Vida — Núm. 26 — Presentación
The age of the universe	La edad del universo
The unification of the personality (second part)	La unificación de la personalidad (segunda parte)
Convergences and divergences: We are not the only planet	Convergencias y divergencias: No somos el único planeta
UAI Leadership Symposium and News	Simposio de Liderazgo de la AUI y Noticias
Luz y Vida — No. 27 — December 2011	Luz y Vida — Núm. 27 — Diciembre 2011
Luz y Vida — No. 27 — Presentation	Luz y Vida — Núm. 27 — Presentación
When does the Thought Adjuster work?	¿Cuándo actúa el Ajustador del Pensamiento?
Facts, meanings, values and other trilogies	Hechos, significados, valores y otras trilogías
Neither secularism nor religion	Ni laicismo ni religión
Convergences and divergences: Human chromosomes	Convergencias y divergencias: Los cromosomas humanos
News from Urantia Association of Spain	Noticias de la Asociación Urantia de España
2012	2012
Luz y Vida — No. 28 — March 2012	Luz y Vida — Núm. 28 — Marzo 2012
Luz y Vida — No. 28 — Presentation	Luz y Vida — Núm. 28 — Presentación
The three levels of universal reality	Los tres niveles de la realidad universal
The spiritual evolution of man for the achievement of mortal survival (first part)	La evolución espiritual del hombre para el logro de la sobrevivencia mortal (primera parte)
What is this?	Qué es esto?
Convergences and Divergences: The Formation of the Solar System	Convergencias y divergencias: La formación del sistema solar
The dissemination of The Urantia Book in the Canary Islands	La difusión de El Libro de Urantia en Canarias
News from Urantia Association of Spain	Noticias de la Asociación Urantia de España
Luz y Vida — No. 29 — June 2012	Luz y Vida — Núm. 29 — Junio 2012
Luz y Vida — No. 29 — Presentation	Luz y Vida — Núm. 29 — Presentación
The XI Meeting of readers	El XI Encuentro de lectores
Leadership in the Urantia Movement	El liderazgo en el movimiento Urantia
Experience and conclusions of the Leadership Symposium	Experiencia y conclusiones del Simposio de Liderazgo
If not me, who?	Si no soy yo, ¿quién?
News from Urantia Association of Spain	Noticias de la Asociación Urantia de España
Luz y Vida — No. 30 — September 2012	Luz y Vida — Núm. 30 — Septiembre 2012
Luz y Vida — No. 30 — Presentation	Luz y Vida — Núm. 30 — Presentación
The spiritual evolution of man for the achievement of mortal survival (last part)	La evolución espiritual del hombre para el logro de la sobrevivencia mortal (última parte)
The Urantia Book and reincarnation	El Libro de Urantia y la reencarnación
The abortion	El aborto
The day to day after The Urantia Book	El día a día después de El Libro de Urantia
News from Urantia Association of Spain	Noticias de la Asociación Urantia de España
Luz y Vida — No. 31 — December 2012	Luz y Vida — Núm. 31 — Diciembre 2012
Luz y Vida — No. 31 — Presentation	Luz y Vida — Núm. 31 — Presentación
The organic evolution of man through the evolutionary levels of the mind	La evolución orgánica del hombre a través de los niveles evolucionarios de la mente
The will of the father	La voluntad del Padre
Life's little things	Las pequeñas cosas de la vida
Convergences and Divergences: The Standard Model	Convergencias y divergencias: el modelo estándar
Reflections on Peace on Urantia	Reflexiones sobre la paz en Urantia
The light is in you	La luz está en ti
News from Urantia Association of Spain	Noticias de la Asociación Urantia de España
2013	2013
Luz y Vida — No. 32 — March 2013	Luz y Vida — Núm. 32 — Marzo 2013
Luz y Vida — No. 32 — Presentation	Luz y Vida — Núm. 32 — Presentación
Our transit to Morontia	Nuestro tránsito a moroncia
Children of God by faith	Hijos de Dios por la fe
Relative truths	Las verdades relativas
Love is the truth	El amor es la verdad
Convergences and Divergences: Quantum Entanglement	Convergencias y divergencias: El entrelazamiento cuántico
News from Urantia Association of Spain	Noticias de la Asociación Urantia de España
Luz y Vida — No. 33 — June 2013	Luz y Vida — Núm. 33 — Junio 2013
Luz y Vida — No. 33 — Presentation	Luz y Vida — Núm. 33 — Presentación
The XII Meeting of readers	El XII Encuentro de lectores
Experiences in the dissemination of the book	Experiencias en la diseminación del libro
News from Urantia Association of Spain	Noticias de la Asociación Urantia de España
Luz y Vida — No. 34 — September 2013	Luz y Vida — Núm. 34 — Septiembre 2013
Luz y Vida — No. 34 — Presentation	Luz y Vida — Núm. 34 — Presentación
Urantia - 606 from Satania (first part)	Urantia - 606 de Satania (primera parte)
Caligastia, free or arrested?	Caligastia, ¿libre o detenido?
A Brief Description of the Creator Son, Jesus of Nazareth	Una breve descripción del Hijo Creador, Jesús de Nazaret
Convergences and divergences: placental mammals	Convergencias y divergencias: los mamíferos placentarios
Urantia Questionnaire: Carmelo Martinez	Cuestionario urantiano: Carmelo Martínez
Luz y Vida — No. 35 — December 2013	Luz y Vida — Núm. 35 — Diciembre 2013
Luz y Vida — No. 35 — Presentation	Luz y Vida — Núm. 35 — Presentación
Urantia - 606 from Satania (second part)	Urantia - 606 de Satania (segunda parte)
Our Father	Padre Nuestro
The Thought Adjusters	Los Ajustadores del Pensamiento
Channeling: error, truth, illusion or innocence	Canalizaciones: error, verdad, ilusión o inocencia
Convergences and divergences: evolution	Convergencias y divergencias: la evolución
Urantia Questionnaire: Jaime Marco	Cuestionario urantiano: Jaime Marco
2014	2014
Luz y Vida — No. 36 — March 2014	Luz y Vida — Núm. 36 — Marzo 2014
Luz y Vida — No. 36 — Presentation	Luz y Vida — Núm. 36 — Presentación
Eugenics: a controversial issue	Eugenesia: un tema controvertido
Death according to The Urantia Book	La muerte según El Libro de Urantia
Only the inner life is really creative	Sólo la vida interior es realmente creativa
Convergences and Divergences: How long does it take to get to Paradise?	Convergencias y divergencias: ¿Cuánto se tarda en llegar al Paraíso?
Urantia Questionnaire: Ismael Grace	Cuestionario urantiano: Ismael Gracia
News from Urantia Association of Spain	Noticias de la Asociación Urantia de España
Luz y Vida — No. 37 — June 2014	Luz y Vida — Núm. 37 — Junio 2014
Luz y Vida — No. 37 — Presentation	Luz y Vida — Núm. 37 — Presentación
The XIII Meeting of readers	El XIII Encuentro de lectores
Michael's Bestowal	El Otorgamiento de Miguel
The discourse on true religion	El discurso sobre la verdadera religión
The parable of the owner of the vineyards	La parábola del propietario de las viñas
The parable of the mines	La parábola de las minas
The last speech in the temple	El último discurso en el templo
Luz y Vida — No. 38 — December 2014	Luz y Vida — Núm. 38 — Diciembre 2014
Luz y Vida — No. 38 — Presentation	Luz y Vida — Núm. 38 — Presentación
The religion of the One	La religión del Uno
Reflections for Readers of The Urantia Book	Reflexiones para los lectores de El Libro de Urantia
Love is invincible	El amor es invencible
God yes, God no	Dios sí, Dios no
Convergences and divergences: appearance on the cosmic scene of matter-energy	Convergencias y divergencias: aparición en la escena cósmica de la materia-energía
Urantia Questionnaire: Eduardo Altuzarra	Cuestionario urantiano: Eduardo Altuzarra
News from Urantia Association of Spain	Noticias de la Asociación Urantia de España
2015	2015
Luz y Vida — No. 39 — March 2015	Luz y Vida — Núm. 39 — Marzo 2015
Luz y Vida — No. 39 — Presentation	Luz y Vida — Núm. 39 — Presentación
Reading The Urantia Book	La lectura de El Libro de Urantia
Tribute to David Zebedee	Homenaje a David Zebedeo
The universe is an incredibly big place	El universo es un lugar increíblemente grande
Convergences and divergences: The adolescence of humanity - the anthropic principle	Convergencias y divergencias: La adolescencia de la humanidad - el principio antrópico
Urantia Questionnaire: Mariano Perez	Cuestionario urantiano: Mariano Pérez
News from Urantia Association of Spain	Noticias de la Asociación Urantia de España
Luz y Vida — No. 40 — June 2015	Luz y Vida — Núm. 40 — Junio 2015
Luz y Vida — No. 40 — Presentation	Luz y Vida — Núm. 40 — Presentación
The XIV Meeting of readers	El XIV Encuentro de lectores
Appearance on the cosmic stage of matter and energy	Aparición en el escenario cósmico de la materia y de la energía
The scribe of Damascus	El escriba de Damasco
Our universe and the universe of The Urantia Book	Nuestro universo y el universo de El Libro de Urantia
Rodan of Alexandria's problem-solving technique	La técnica de resolución de problemas de Rodán de Alejandría
Luz y Vida — No. 41 — September 2015	Luz y Vida — Núm. 41 — Septiembre 2015
Luz y Vida — No. 41 — Presentation	Luz y Vida — Núm. 41 — Presentación
Reflections for educators and believers of the fifth revelation	Reflexiones para los educadores y creyentes de la quinta revelación
The eternal struggle between science and religion	La eterna lucha entre ciencia y religión
Convergences and divergences: agriculture	Convergencias y divergencias: la agricultura
Urantia Questionnaire: Maria José Sánchez Santamaría	Cuestionario urantiano: Maria José Sánchez Santamaría
News from Urantia Association of Spain	Noticias de la Asociación Urantia de España
Luz y Vida — No. 42 — December 2015	Luz y Vida — Núm. 42 — Diciembre 2015
Luz y Vida — No. 42 — Presentation	Luz y Vida — Núm. 42 — Presentación
Matrix owns us	Matrix nos posee
Visions of the future for people with vision of the future	Visiones de futuro para gente con visión de futuro
The School of The Urantia Book on the Internet	La Escuela de El Libro de Urantia en Internet
Convergences and divergences also of values	Convergencias y divergencias también de valores
Urantia Questionnaire: Santiago Rodriguez	Cuestionario urantiano: Santiago Rodríguez
News from Urantia Association of Spain	Noticias de la Asociación Urantia de España
2016	2016
Luz y Vida — No. 43 — March 2016	Luz y Vida — Núm. 43 — Marzo 2016
Luz y Vida — No. 43 — Presentation	Luz y Vida — Núm. 43 — Presentación
The ninth planet in light of The Urantia Book	El noveno planeta a la luz de El Libro de Urantia
Eugenics for these times	Eugenesia para estos tiempos
Convergences and divergences: gravitational waves	Convergencias y divergencias: las ondas gravitacionales
Urantia Questionnaire: Olga Lopez	Cuestionario urantiano: Olga López
News from Urantia Association of Spain	Noticias de la Asociación Urantia de España
Luz y Vida — No. 44 — June 2016	Luz y Vida — Núm. 44 — Junio 2016
Luz y Vida — No. 44 — Presentation	Luz y Vida — Núm. 44 — Presentación
Chronicle of the XV Meeting	Crónica del XV Encuentro
The ascension race from a bird's eye view	La carrera de ascensión a vista de pájaro
The aids of the ascension career: internal and physical/material	Las ayudas de la carrera de ascensión: internas y físicas/materiales
The survival of the personality	La supervivencia de la personalidad
The free will	El libre albedrío
Luz y Vida — No. 45 — September 2016	Luz y Vida — Núm. 45 — Septiembre 2016
Luz y Vida — No. 45 — Presentation	Luz y Vida — Núm. 45 — Presentación
Argumentative Fallacies and Examples Related to The Urantia Book	Falacias argumentativas y ejemplos relacionados con El Libro de Urantia
The government of a neighboring planet: the possible utopia	El gobierno de un planeta vecino: la utopía posible
The majesty of being able to choose: free will	La majestad de poder elegir: el libre albedrío
Convergences and divergences: The expansion of knowledge: Agriculture II	Convergencias y divergencias: La expansión del conocimiento: La Agricultura II
Urantia Questionnaire: Miguel Bustos	Cuestionario urantiano: Miguel Bustos
2021	2021
Luz y Vida — March 2021	Luz y Vida — Marzo 2021
Luz y Vida — March 2021 — Newsletter	Luz y Vida — Marzo 2021 — Boletín
Luz y Vida — March 2021 — Editorial	Luz y Vida — Marzo 2021 — Editorial
Urantiapedia, a Wikipedia of The Urantia Book	Urantiapedia, una Wikipedia de El Libro de Urantia
Luz y Vida — April 2021	Luz y Vida — Abril 2021
Luz y Vida — April 2021 — Newsletter	Luz y Vida — Abril 2021 — Boletín
The astronomical secrets of the sky	Los secretos astronómicos del cielo
Urantia Questionnaire: Ginés Avilés	Cuestionario Urantiano: Ginés Avilés
Luz y Vida — May 2021	Luz y Vida — Mayo 2021
Luz y Vida — May 2021 — Newsletter	Luz y Vida — Mayo 2021 — Boletín
Urantia Questionnaire: Ana María García	Cuestionario Urantiano: Ana María García
Luz y Vida — June 2021	Luz y Vida — Junio 2021
Luz y Vida — June 2021 — Newsletter	Luz y Vida — Junio 2021 — Boletín
The quality of a better society	La calidad de una sociedad mejor
Urantia Questionnaire: José Luis Navarro	Cuestionario Urantiano: José Luis Navarro
Luz y Vida — September 2021	Luz y Vida — Septiembre 2021
Luz y Vida — September 2021 — Newsletter	Luz y Vida — Septiembre 2021 — Boletín
Urantia Questionnaire: Jorge Nagore	Cuestionario Urantiano: Jorge Nagore
Luz y Vida — October 2021	Luz y Vida — Octubre 2021
Luz y Vida — October 2021 — Newsletter	Luz y Vida — Octubre 2021 — Boletín
My favorite paragraph	Mi párrafo favorito
Urantia Questionnaire: Luis Coll	Cuestionario Urantiano: Luis Coll
Luz y Vida — November 2021	Luz y Vida — Noviembre 2021
Luz y Vida — November 2021 — Newsletter	Luz y Vida — Noviembre 2021 — Boletín
Luz y Vida — November 2021 — Editorial	Luz y Vida — Noviembre 2021 — Editorial
Urantia Questionnaire: Antonio Moya	Cuestionario Urantiano: Antonio Moya
Luz y Vida — December 2021	Luz y Vida — Diciembre 2021
Luz y Vida — December 2021 — Newsletter	Luz y Vida — Diciembre 2021 — Boletín
Luz y Vida — December 2021 — Editorial	Luz y Vida — Diciembre 2021 — Editorial
The secrets of water	Los secretos del agua
Urantia Questionnaire: Paco Morón	Cuestionario Urantiano: Paco Morón
2022	2022
Luz y Vida — January 2022	Luz y Vida — Enero 2022
Luz y Vida — January 2022 — Newsletter	Luz y Vida — Enero 2022 — Boletín
Luz y Vida — January 2022 — Editorial	Luz y Vida — Enero 2022 — Editorial
Urantia Questionnaire: Gloria Andreu	Cuestionario Urantiano: Gloria Andreu
Luz y Vida — February 2022	Luz y Vida — Febrero 2022
Luz y Vida — February 2022 — Newsletter	Luz y Vida — Febrero 2022 — Boletín
Luz y Vida — February 2022 — Editorial	Luz y Vida — Febrero 2022 — Editorial
Urantia Reflections: Universal Truth, No Dogma	Reflexiones urantianas: Verdad universal, sin dogmas
Urantia Questionnaire: Victoriano Izquierdo	Cuestionario Urantiano: Victoriano Izquierdo
Luz y Vida — April 2022	Luz y Vida — Abril 2022
Luz y Vida — April 2022 — Newsletter	Luz y Vida — Abril 2022 — Boletín
Luz y Vida — April 2022 — Editorial	Luz y Vida — Abril 2022 — Editorial
Navigating Life – The Evolutionary Levels of Emotions	Navegando por la vida – Los niveles evolutivos de las emociones
Urantia Questionnaire: Esteban Cotán	Cuestionario Urantiano: Esteban Cotán
Luz y Vida — May 2022	Luz y Vida — Mayo 2022
Luz y Vida — May 2022 — Newsletter	Luz y Vida — Mayo 2022 — Boletín
Luz y Vida — May 2022 — Editorial	Luz y Vida — Mayo 2022 — Editorial
Urantia Questionnaire: Gema Villa	Cuestionario Urantiano: Gema Villa
Luz y Vida — June 2022	Luz y Vida — Junio 2022
Luz y Vida — June 2022 — Newsletter	Luz y Vida — Junio 2022 — Boletín
Luz y Vida — June 2022 — Editorial	Luz y Vida — Junio 2022 — Editorial
My favorite paragraph	Mi párrafo favorito
Luz y Vida — September 2022	Luz y Vida — Septiembre 2022
Luz y Vida — September 2022 — Newsletter	Luz y Vida — Septiembre 2022 — Boletín
Luz y Vida — September 2022 — Editorial	Luz y Vida — Septiembre 2022 — Editorial
Urantia Questionnaire: Juan José López Vallejos	Cuestionario Urantiano: Juan José López Vallejos
Luz y Vida — October 2022	Luz y Vida — Octubre 2022
Luz y Vida — October 2022 — Newsletter	Luz y Vida — Octubre 2022 — Boletín
Luz y Vida — October 2022 — Editorial	Luz y Vida — Octubre 2022 — Editorial
Urantian reflections	Reflexiones urantianas
Urantia Questionnaire: Jeannie Vázquez de Abreu	Cuestionario Urantiano: Jeannie Vázquez de Abreu
Luz y Vida — November 2022	Luz y Vida — Noviembre 2022
Luz y Vida — November 2022 — Newsletter	Luz y Vida — Noviembre 2022 — Boletín
Luz y Vida — November 2022 — Editorial	Luz y Vida — Noviembre 2022 — Editorial
My favorite paragraph	Mi párrafo favorito
Luz y Vida — December 2022	Luz y Vida — Diciembre 2022
Luz y Vida — December 2022 — Newsletter	Luz y Vida — Diciembre 2022 — Boletín
Luz y Vida — December 2022 — Editorial	Luz y Vida — Diciembre 2022 — Editorial
Urantia Questionnaire: Christian Figueroa	Cuestionario Urantiano: Christian Figueroa
2023	2023
Luz y Vida — January 2023	Luz y Vida — Enero 2023
Luz y Vida — January 2023 — Newsletter	Luz y Vida — Enero 2023 — Boletín
Luz y Vida — January 2023 — Editorial	Luz y Vida — Enero 2023 — Editorial
Urantia Questionnaire: Marisé Cantero	Cuestionario Urantiano: Marisé Cantero
Luz y Vida — February 2023	Luz y Vida — Febrero 2023
Luz y Vida — February 2023 — Newsletter	Luz y Vida — Febrero 2023 — Boletín
Luz y Vida — February 2023 — Editorial	Luz y Vida — Febrero 2023 — Editorial
Urantia Reflections: Awakening to a New Consciousness (Part One)	Reflexiones urantianas: Despertar a una nueva consciencia (primera parte)
Urantia Questionnaire: Javier Martínez	Cuestionario Urantiano: Javier Martínez
Luz y Vida — March 2023	Luz y Vida — Marzo 2023
Luz y Vida — March 2023 — Newsletter	Luz y Vida — Marzo 2023 — Boletín
Luz y Vida — March 2023 — Editorial	Luz y Vida — Marzo 2023 — Editorial
Urantia Reflections: Awakening to a New Consciousness (Part Two)	Reflexiones urantianas: Despertar a una nueva consciencia (segunda parte)
Urantia Questionnaire: Martín Guzmán	Cuestionario Urantiano: Martín Guzmán
Luz y Vida — April 2023	Luz y Vida — Abril 2023
Luz y Vida — April 2023 — Newsletter	Luz y Vida — Abril 2023 — Boletín
Luz y Vida — April 2023 — Editorial	Luz y Vida — Abril 2023 — Editorial
Urantia Questionnaire: Omar Delgado	Cuestionario Urantiano: Omar Delgado
Luz y Vida — May 2023	Luz y Vida — Mayo 2023
Luz y Vida — May 2023 — Newsletter	Luz y Vida — Mayo 2023 — Boletín
Luz y Vida — May 2023 — Editorial	Luz y Vida — Mayo 2023 — Editorial
Luz y Vida — June 2023	Luz y Vida — Junio 2023
Luz y Vida — June 2023 — Newsletter	Luz y Vida — Junio 2023 — Boletín
Luz y Vida — June 2023 — Editorial	Luz y Vida — Junio 2023 — Editorial
Urantia Questionnaire: Jan Herca	Cuestionario Urantiano: Jan Herca
Luz y Vida — July-August 2023	Luz y Vida — Julio-Agosto 2023
Luz y Vida — July-August 2023 — Newsletter	Luz y Vida — Julio-Agosto 2023 — Boletín
Luz y Vida — July-August 2023 — Editorial	Luz y Vida — Julio-Agosto 2023 — Editorial
Urantia Questionnaire: Montserrat Blanco	Cuestionario Urantiano: Montserrat Blanco
Luz y Vida — September 2023	Luz y Vida — Septiembre 2023
Luz y Vida — September 2023 — Newsletter	Luz y Vida — Septiembre 2023 — Boletín
Luz y Vida — September 2023 — Editorial	Luz y Vida — Septiembre 2023 — Editorial
My favorite paragraph	Mi párrafo favorito
Urantia Questionnaire: Julieta Quintero	Cuestionario Urantiano: Julieta Quintero
Luz y Vida — October 2023	Luz y Vida — Octubre 2023
Luz y Vida — October 2023 — Newsletter	Luz y Vida — Octubre 2023 — Boletín
Luz y Vida — October 2023 — Editorial	Luz y Vida — Octubre 2023 — Editorial
Presentations from the 19th Urantia Book Readers' Meeting in Spain	Presentaciones del XIX Encuentro de Lectores de El libro de Urantia en España
19th Readers’ Meeting – Ciudad Real, 2023	XIX Encuentro de lectores – Ciudad Real, 2023
Luz y Vida — November 2023	Luz y Vida — Noviembre 2023
Luz y Vida — November 2023 — Newsletter	Luz y Vida — Noviembre 2023 — Boletín
Luz y Vida — November 2023 — Editorial	Luz y Vida — Noviembre 2023 — Editorial
My favorite paragraph	Mi párrafo favorito
Urantia Questionnaire: Fernando Carazo	Cuestionario Urantiano: Fernando Carazo
Luz y Vida — December 2023	Luz y Vida — Diciembre 2023
Luz y Vida — December 2023 — Newsletter	Luz y Vida — Diciembre 2023 — Boletín
Luz y Vida — December 2023 — Editorial	Luz y Vida — Diciembre 2023 — Editorial
My favorite paragraph	Mi párrafo favorito
Urantia Questionnaire: Mariano Pérez	Cuestionario Urantiano: Mariano Pérez
Luz y Vida — January 2024	Luz y Vida — Enero 2024
Luz y Vida — January 2024 — Newsletter	Luz y Vida — Enero 2024 — Boletín
Luz y Vida — January 2024 — Editorial	Luz y Vida — Enero 2024 — Editorial
My favorite paragraph	Mi párrafo favorito
Urantia Questionnaire: Luis García Bory	Cuestionario Urantiano: Luis García Bory
2024	2024
Luz y Vida — Febrero 2024	Luz y Vida — Febrero 2024
Luz y Vida — Febrero 2024 — Newsletter	Luz y Vida — Febrero 2024 — Boletín
Luz y Vida — Febrero 2024 — Editorial	Luz y Vida — Febrero 2024 — Editorial
Urantia Questionnaire: Ramiro Cuestas	Cuestionario Urantiano: Ramiro Cuestas
Luz y Vida — March 2024	Luz y Vida — Marzo 2024
Luz y Vida — March 2024 — Newsletter	Luz y Vida — Marzo 2024 — Boletín
Luz y Vida — March 2024 — Editorial	Luz y Vida — Marzo 2024 — Editorial
My favorite paragraph	Mi párrafo favorito
Urantia Questionnaire: Juan Antonio Figal Mañas	Cuestionario Urantiano: Juan Antonio Figal Mañas
Luz y Vida — April 2024	Luz y Vida — Abril 2024
Luz y Vida — April 2024 — Newsletter	Luz y Vida — Abril 2024 — Boletín
Luz y Vida — April 2024 — Editorial	Luz y Vida — Abril 2024 — Editorial
Urantia Questionnaire: Ana Eguren	Cuestionario Urantiano: Ana Eguren
The Madrid Study Group celebrates its 20th anniversary	El Grupo de Estudio de Madrid cumple 20 años
Luz y Vida — May 2024	Luz y Vida — Mayo 2024
Luz y Vida — May 2024 — Newsletter	Luz y Vida — Mayo 2024 — Boletín
Luz y Vida — May 2024 — Editorial	Luz y Vida — Mayo 2024 — Editorial
My favorite paragraph	Mi párrafo favorito
Urantia Questionnaire: Luis Alfonso Rojas Rosillo	Cuestionario Urantiano: Luis Alfonso Rojas Rosillo
Luz y Vida — June 2024	Luz y Vida — Junio 2024
Luz y Vida — June 2024 — Newsletter	Luz y Vida — Junio 2024 — Boletín
Luz y Vida — June 2024 — Editorial	Luz y Vida — Junio 2024 — Editorial
My favorite paragraph	Mi párrafo favorito
Urantia Questionnaire: Romualdo Soler González	Cuestionario Urantiano: Luis Romualdo Soler González
Luz y Vida — July-August 2024	Luz y Vida — Julio-Agosto 2024
Luz y Vida — July-August 2024 — Newsletter	Luz y Vida — Julio-Agosto 2024 — Boletín
Luz y Vida — July-August 2024 — Editorial	Luz y Vida — Julio-Agosto 2024 — Editorial
Presentations from the 20th Urantia Book Readers' Meeting in Spain	Presentaciones del XX Encuentro de Lectores de El libro de Urantia en España
20th Meeting of readers of The Urantia Book in Spain	XX Encuentro de lectores de El libro de Urantia en España
Report on the Circle of Trust	Informe sobre el Círculo de Confianza
Luz y Vida — September 2024	Luz y Vida — Septiembre 2024
Luz y Vida — September 2024 — Newsletter	Luz y Vida — Septiembre 2024 — Boletín
Luz y Vida — September 2024 — Editorial	Luz y Vida — Septiembre 2024 — Editorial
Other books on spiritual growth	Otros libros de crecimiento espiritual
My favorite paragraph	Mi párrafo favorito
Urantia Questionnaire: Jaime Marco	Cuestionario Urantiano: Jaime Marco
In memory of Esteban Cotán (1927-2024)	En recuerdo de Esteban Cotán (1927-2024)
Luz y Vida — October 2024	Luz y Vida — Octubre 2024
Luz y Vida — October 2024 — Newsletter	Luz y Vida — Octubre 2024 — Boletín
Luz y Vida — October 2024 — Editorial	Luz y Vida — Octubre 2024 — Editorial
Navigating through life: Serenity	Navegando por la vida: La serenidad
My favorite paragraph	Mi párrafo favorito
Urantia Questionnaire: Ulises Pedrique	Cuestionario Urantiano: Ulises Pedrique
Luz y Vida — November 2024	Luz y Vida — Noviembre 2024
Luz y Vida — November 2024 — Newsletter	Luz y Vida — Noviembre 2024 — Boletín
Luz y Vida — November 2024 — Editorial	Luz y Vida — Noviembre 2024 — Editorial
Navigating through life: I explain myself to God	Navegando por la vida: Me explico ante Dios
My favorite paragraph	Mi párrafo favorito
Luz y Vida — December 2024	Luz y Vida — Diciembre 2024
Luz y Vida — December 2024 — Newsletter	Luz y Vida — Diciembre 2024 — Boletín
Luz y Vida — December 2024 — Editorial	Luz y Vida — Diciembre 2024 — Editorial
My favorite paragraph	Mi párrafo favorito
Urantia Questionnaire: Víctor García Bory	Cuestionario Urantiano: Víctor García Bory
Luz y Vida — January 2025	Luz y Vida — Enero 2025
Luz y Vida — January 2025 — Newsletter	Luz y Vida — Enero 2025 — Boletín
Luz y Vida — January 2025 — Editorial	Luz y Vida — Enero 2025 — Editorial
My favorite paragraph	Mi párrafo favorito
Urantia Questionnaire: Julio J. Miranda	Cuestionario Urantiano: Julio J. Miranda