Index of Study Aids	Índice de Ayudas de Estudio
The Urantia Book Workbooks and other works by William S. Sadler, MD	Los libros de trabajo de El libro de Urantia y otras obras de William S. Sadler, MD
Foreword and Part I — Volume I	Prólogo y primera parte — Volumen I
Science — Volume II	Ciencia — Volumen II
Topical and Doctrinal Studies — Volume III	Estudios temáticos y doctrinales — Volumen III
Jesus — Volume IV	Jesús — Volumen IV
Theology — Volume V	Teología — Volumen V
Bible Study — Volume VI	Estudio Bíblico — Volumen VI
Terminology — Volume VII	Terminología — Volumen VII
Worship and Wisdom — Volume VIII	Adoración y Sabiduría — Volumen VIII
Consideration of Some Criticisms of The Urantia Book	Consideración de algunas críticas al libro de Urantia
A History of the Urantia Movement	Una historia del movimiento Urantia
Works by William S. Sadler, Jr.	Estudios de William S. Sadler, Jr.
A Study of the Master Universe	Estudio del Universo Maestro
Appendices to A Study of the Master Universe	Apéndices al «Estudio del Universo Maestro»
Bill Sadler Talks	Charlas de Bill Sadler
Concerning Human Survival	Sobre la supervivencia humana
General Organization of The Urantia Book	Organización general del libro de Urantia
A Simplification of the Foreword to The Urantia Book	Simplificación del Prólogo de El Libro de Urantia
Other Studies	Otros estudios
FAQ - Frequently asked questions about The Urantia Book	Preguntas frecuentes — Preguntas frecuentes sobre El libro de Urantia
Guide to Pronunciation of Names and Words in The Urantia Book	Guía para la pronunciación de nombres y palabras en El libro de Urantia
How The Urantia Papers came to be — according to The Revelators	Cómo se crearon los Documentos de Urantia, de acuerdo a los Reveladores
An Artist's Conception of the Master Universe	Una concepción artística del universo maestro
A Strategy and Practice for In-depth Study Groups of The Urantia Book	Estrategia y práctica para grupos de estudio en profundidad del libro de Urantia
The Value of Study Groups	El valor de los grupos de estudio
The Unceasing Campaign of the Master Seraphim	La incesante campaña de los maestros serafines
How to Host a Virtual Study Group Using Skype	Cómo organizar un grupo de estudio virtual usando Skype
Business on Urantia — The Big Picture	Negocios en Urantia: el panorama general
On the Claim of Revelatory Status — Past, Present, and Future	Sobre la reivindicación del estatus revelador: pasado, presente y futuro
God’s CD Collection	Colección de CD de Dios
Mota-vation	Mota-vación
True Succcess	El verdadero éxito
Spiritual practices for walking the ‘ROPE’	Prácticas espirituales para caminar la «CUERDA» («ROPE»)
The Unfinished Business of the Fourth Epochal Revelation	La tarea pendiente de la cuarta revelación de época